Time To Play - DJ Noriken - HYBRID MONSTER 3 - 
Memories (Do You Remember?) - Fidel Wicked - Let My Music Play - 
Graces of Heaven - aran - HARDCORE SYNDROME 7 - 
Fake Ass Bitches - 2Pac - R U Still Down? (Remember Me) - 
STYX HELIX - MYTH & ROID - STYX HELIX - 
Breeder - Abitan - HYBRID MONSTER 2 - 
Burst the Gravity - ALTIMA - Burst the Gravity - 
Natsukashii - AHBSNT - 
Stargazer - Aether - 
Faded - Alan Walker - Faded - 
Brave Shine - Aimer - Brave Shine - 
Sing Me to Sleep - Alan Walker - Sing Me to Sleep - 
Willst du - Alligatoah - Triebwerke - 
Furia - 7UBO - 
Speedhunter - Alex Skrindo - 
Flim - Aphex Twin - Come to Daddy - 
Anubis - Brandberg - 
Anvil - Lorn - Vessel - 
Apocalypse - Cigarettes After Sex - Cigarettes After Sex - 
Windowlicker - Aphex Twin - Windowlicker - 
The Vividness of Memory - Aran - Bright Colors - 
Emoticon - aran - Bright Colors 3 - 
Arclight - aran - ARATOSHI - 
Enchanted Leaf - aran - HARDCORE SYNDROME 9 - 
Refound - aran - IRREGULAR NATION 2 - 
Rock the Vox - aran - Bright Colors 2 - 
Do I Wanna Know? - Arctic Monkeys - Do I Wanna Know? - 
LOGIN - AshZone - 
Space Oddity - Chris Hadfield - Space Sessions: Songs From a Tin Can - 
Avalanche - Quil - The Far East Hard Session - 
Nightmare - Avenged Sevenfold - Nightmare - 
Afterlife - Avenged Sevenfold - Avenged Sevenfold - 
Never Sober - Avenza - 
Girlfriend - Avril Lavigne - The Best Damn Thing - 
Hello Kitty - Avril Lavigne - Hello Kitty - 
Run - AWOLNATION - Run - 
Bad Karma - Axel Thesleff - Bad Karma - 
Harlem Shake - Baauer - Harlem Shake - 
KARATE - BABYMETAL - METAL RESISTANCE - 
Kaleidoscope - BADBADNOTGOOD - III - 
Saturday - Basshunter - Calling Time - 
Of the Night - Bastille - Of the Night - 
Heaven Is a Place on Earth - Belinda Carlisle - Heaven on Earth - 
The Signal - BertycoX - The Signal - 
So Sweet Bitter Days - Betwixt & Between - Bright Colors - 
bad guy - Billie Eilish - WHEN WE ALL FALL ASLEEP, WHERE DO WE GO? - 
Just a Bill - Billy the Fridge - Old Fashioned - 
Breach - Black Sun Empire - Driving Insane - 
Eraser - Black Sun Empire - Lights and Wires - 
Black Out - Overload - SUPER EUROBEAT presents INITIAL D 〜D SELECTION 3〜 - 
Dopamine - Blackstripe - 
WOHO - Blackstripe - 
Sure Be Cool If You Did - Blake Shelton - Based on a True Story... - 
Uhn Tiss Uhn Tiss Uhn Tiss - Bloodhound Gang - Uhn Tiss Uhn Tiss Uhn Tiss - 
Blood on Your Blade - Night Club - Scary World - 
Eyes on Fire - Blue Foundation - Life of a Ghost - 
Everything You Do Is a Balloon - Boards of Canada - Hi Scores - 
Rasputin - Boney M. - The Greatest Hits - 
Border Is Nothing (Noizenecio remix) - RoughSketch - The Far East Hard Session - 
Release the Beast - Breakwater - Splashdown - 
Blackout - Breathe Carolina - 
Shadow Moses - Bring Me the Horizon - Sempiternal - 
Break the Ice - Britney Spears - Blackout - 
Runaway Baby - Bruno Mars - Doo-Wops & Hooligans - 
Imaginary Places - Busdriver - 
Delta - C2C - 
You Used to Hold Me - Calvin Harris - Ready for the Weekend - 
Safe and Sound - Capital Cities - In a Tidal Wave of Mystery - 
Hello - Capsule - 
Dramophone - Caravan Palace - Panic - 
Miracle - Caravan Palace - Miracle - 
Wonderland - Caravan Palace - <|°_°|> - 
Everytime We Touch - Cascada - 
Catchit - S3RL - 
Chain - Back-On - 
Ready Set Roll - Chase Rice - Ignite the Night - 
3005 - Childish Gambino - 3005 - 
Bonfire - Childish Gambino - Camp - 
Redbone - Childish Gambino - Redbone - 
Bubble Dream - CHON - 
Story - CHON - 
Lord of the Dance - Chris Clark - 
Genie in a Bottle - Christina Aguilera - Christina Aguilera - 
Sakitnya Tuh Disini - Cita Citata - Sakitnya Tuh Disini - 
Sofia - Clairo - Immunity - 
Haven - Clarx - 
Ohmygodiloveyoupleasedontleaveme - Clever Girl - 
Clouds - Zach Sobiech - Clouds - 
Koto - CloZee - Koto - 
Hello Bitches - CL - Hello Bitches - 
Every Teardrop Is a Waterfall - Coldplay - Every Teardrop Is a Waterfall - 
Fortunate Son - Creedence Clearwater Revival - 
Overcharge - crt_head - Power Up - 
Crush - Cigarettes After Sex - Crush - 
C.U.R.E. - BOOTS - AQUARIA - 
Impacto - Daddy Yankee - El Cartel: The Big Boss - 
Aerodynamic - Daft Punk - Discovery - 
Crescendolls - Daft Punk - Discovery - 
Face to Face - Daft Punk - Discovery - 
End of Line - Daft Punk - TRON: Legacy - 
One More Time / Aerodynamic - Daft Punk - Alive 2007 - 
Da Funk - Daft Punk - Homework - 
One More Time - Daft Punk - Discovery - 
Something About Us - Daft Punk - Discovery - 
Television Rules the Nation - Daft Punk - Human After All - 
Veridis Quo - Daft Punk - Discovery - 
Daisuke - El Huervo - Do Not Lay Waste to Homes... - 
Voyager - Daft Punk - Discovery - 
Tunak Tunak Tun - Daler Mehndi - Tunak Tunak Tun - 
Dancing in the Moonlight - Toploader - Onka's Big Moka - 
Beat of the Rising Sun - Dave Rodgers - SUPER EUROBEAT presents INITIAL D 〜D SELECTION 3〜 - 
Boom Boom Japan - Dave Rodgers - SUPER EUROBEAT presents INITIAL D 〜D SELECTION 3〜 - 
Saturday Night Fever - Dave Rodgers - SUPER EUROBEAT presents INITIAL D 〜D SELECTION 3〜 - 
I Need Your Love - Dave Simon - SUPER EUROBEAT presents INITIAL D 〜D SELECTION 2〜 - 
The Alphabeat - David Guetta - Nothing but the Beat - 
Just Girly Things - Dawin - 
Drive My Car - DEAMN - 
Sirensong - Decemberkid & Ken Raka - 
White Flag - Delta Heavy - Paradise Lost - 
Phantom Killer - DJ Myosuke - STORYTELLER VOLUME 1 - 
Bassline Disco - DJ Noriken - RADIANCE - 
Be All Out (Enraged_3x3) - DJ Noriken - Hybrid Monster - 
Elektrikshot - DJ Noriken - ABSOLUTE - 
Taurus (Fatal Attack) - DJ Noriken - ZODIAX EP - 
Flower Dance - DJ Okawari - A Cup Of Coffee - 
Luv Letter - DJ Okawari - Libyus Music Sound History 2004-2010 - 
(Make Some Noize) Smack My Rave - DJ Shimamura - MAX - 
STOMP the Showtime - DJ Laugh - Bright Colors 2 - 
Randomize to Euphoria - DJ Noriken - Bright Colors - 
F33L 1T - DJ Noriken - HARDCORE SYNDROME X - 
F33L 1T (Getty Remix) - DJ Noriken - Resurrection X - 
Tonight, Alright - DJ Noriken - YABAICORE - 
U Bring Me Joy - DJ Shimamura - Bright Colors 4 - 
X Gon' Give It To Ya - DMX - 
Don't Stop Believin' - Journey - Revelation - 
Battle Cry - DotEXE - Monstercat 018: Frontier - 
What's The Difference - Dr. Dre - 2001 - 
Boogie Wonderland - Earth, Wind & Fire - The Great Earth, Wind & Fire - 
Let's Groove - Earth, Wind & Fire - 
September - Earth, Wind & Fire - The Best of Earth, Wind & Fire, Volume 1 - 
Departure - Ed Harrison - 
Wings - EDEN - 
Galway Girl - Ed Sheeran - ÷ - 
Shape of You - Ed Sheeran - ÷ - 
Bully - Fusk Asker - 
Regain Control - Shirobon - Distant Reality - 
Lost Into the Night - ELISA - SUPER EUROBEAT presents INITIAL D 〜D SELECTION 2〜 - 
Rap God - Eminem - The Marshall Mathers LP 2 - 
Pneumatic Tokyo - EnV - 
Eolian Oms - Jade Cicada - 
Вите надо выйти - Estradarada - Дискотека века - 
Centuries - Fall Out Boy - 
This Ain't a Scene, It's an Arms Race - Fall Out Boy - Infinity on High - 
Falling in Love - Cigarettes After Sex - Falling in Love - 
Fast Car - Tracy Chapman - Tracy Chapman - 
Handlebars - Flobots - Handlebars - 
COLORS - FLOW - COLORS - 
The Pretender - Foo Fighters - Greatest Hits - 
Waiting for a Girl Like You - Foreigner - 
Don't Stop (Color on the Walls) - Foster the People - Torches - 
Stacy's Mom - Fountains of Wayne - Stacy's Mom - 
Hometown - French 79 - Joshua - 
Don't Fake The Funk. - Funklow. - 
Cutie Cutie - Fusq - 
Perfume! - Fusq - 
New World - iMeiden - 
MIRAI - GARNiDELiA - MIRAI - 
Black - GAZIROVKA - NEBOBLAKA - 
Blaze - Getty - YABAICORE - 
Doggy Tails - Getty - J-NERATION TOYS - 
Raving Hype - Getty - HARDCORE SYNDROME 12 - 
GHOST IN THE SHELL ARISE - Cornelius - 攻殻機動隊ARISE O.S.T. - 
Ghost in the Shell Arise - Cornelius - 
Weather - Ginger Root - Weather - 
Once Again - Girl Talk - Night Ripper - 
Casin - glue70 - 
Schweine - Glukoza - 
King Taco - Goblins From Mars - Vol. 2 (Originals) - 
MATZcore - goreshit - my love feels all wrong - 
nhk!? - goreshit - my love feels all wrong - 
o'er the flood - goreshit - semantic compositions on death and its meaning - 
the nature of dying - goreshit - semantic compositions on death and its meaning - 
19-2000 - Gorillaz - Gorillaz - 
Clint Eastwood - Gorillaz - Gorillaz - 
On Melancholy Hill - Gorillaz - Plastic Beach - 
Dirty Harry - Gorillaz - Dirty Harry - 
Мальчик Party - GRIVINA - Танцую одна - 
Halcyon - xi - Parousia - 
21 Guns - Green Day - 21st Century Breakdown - 
Day One - Hans Zimmer - Interstellar - 
Kay-LynnX10 - Goth Von Core - 
U Got That - Halogen - U Got That - 
Mountains - Hans Zimmer - Interstellar - 
No Time for Caution - Hans Zimmer - Interstellar - 
Salty Hyperlaser - DJ NECOJITA - J-NERATION 6 - 
narkotik kal - Hard Bass School - 
Galaxxxy_Burst - DJ Shimamura - HARDCORE SYNDROME 5 - 
Ouija - Harley Poe - Satan, Sex and No Regrets - 
HeavenZ-ArmZ - sasakure.UK - 
Crank It Up - HI-LO - 
Should Have Known Better - Hinder - Welcome to the Freakshow - 
SpaceJellyfish - クラゲ - HoneyComeBear - 
Indigo Blossom - Hoverboots - 
Mutual - HVNNIBVL - 
I Don't Want to Set the World on Fire - The Ink Spots - The Anthology - 
Pop Culture - Icon for Hire - Icon for Hire - 
Alga - IGNEA - The Sign of Faith - 
Illusion (instrumental) - Approaching Nirvana - Illusions - 
Imaginary Friend - Night Club - Scary World - 
Imma Be A Raver - Yultron - 
Hide and Seek - Imogen Heap - Hide and Seek - 
Don't Stop the Music - Lou Grant - SUPER EUROBEAT PRESENTS INITIAL D D SELECTION - 
No One Sleep in Tokyo - Edo Boys - SUPER EUROBEAT PRESENTS INITIAL D D SELECTION - 
Spark in the Dark - Man Power - SUPER EUROBEAT PRESENTS INITIAL D D SELECTION - 
Everybody's Warming - Tension - SUPER EUROBEAT presents INITIAL D 〜D SELECTION 2〜 - 
First Step - Hans Zimmer - Interstellar: Original Motion Picture Soundtrack - 
Tick-Tock - Hans Zimmer - Interstellar - 
Cluster A - in the blue shirt - Cyanotype - 
In the End - Linkin Park - Hybrid Theory - 
Keep Being You - Isyana Sarasvati - Explore! - 
Flavour - Itro - 
SOLOMON - Yooh - ABSOLUTE - 
Ceria - J-Rocks - 
Jenny - Studio Killers - Studio Killers - 
Be My Babe - Jilly - SUPER EUROBEAT PRESENTS INITIAL D D SELECTION - 
SLOW DANCING IN THE DARK - Joji - BALLADS 1 - 
I'm Not Racist - Joyner Lucas - I'm Not Racist - 
La camisa negra - Juanes - Mi sangre - 
Genesis - Justice - ✝ - 
Waters of Nazareth - Justice - ✝ - 
K. - Cigarettes After Sex - Cigarettes After Sex - 
Carry on Wayward Son - Kansas - Mullets Rock! - 
Good Morning - Kanye West - Graduation - 
Julia - Kaosic - 
E.T. - Katy Perry - Teenage Dream - 
Roadgame - Kavinsky - OutRun - 
Absolute Territory - Ken Ashcorp - Absolute Territory - 
We're Shameless - Ken Ashcorp - 
ListEN to my fuckiNg shit - kenta-v.ez. - Bright Colors 2 - 
Swimming Pools (Drank) - Kendrick Lamar - 
shAdow brEAk - kenta-v.ez. - Bright Colors 3 - 
A New Day Dawns - Kero One - 
The Illness - Kid606 - 
Feels - Kiiara - Low Kii Savage - 
Gold - Kiiara - Low Kii Savage - 
Tennessee - Kiiara - Low Kii Savage - 
Summer Daze - Kill Paris - Galaxies Between Us - 
Kill The Deadline - Hommarju - We Are Connected - 
Undressed - Kim Cesarion - Undressed - 
Dancing Queen - King & Queen - SUPER EUROBEAT presents INITIAL D 〜D SELECTION 2〜 - 
Tool-Assisted Speedcore - Kobaryo - The Psycho Blast Vol.1  - 
Bonfire - Knife Party - Rage Valley - 
That's Where It All Started - Kognitif - Soul Food - 
Into the Labyrinth - Kraddy - Labyrinth - 
Be There - Krewella - Be There - 
Broken Record - Krewella - Ammunition - 
Thé à la menthe - La Caution - 
Thé à la menthe - La Caution - Peines de maures - 
LoveGame - Lady Gaga - The Fame - 
Paparazzi - Lady Gaga - 
Last Resort - Papa Roach - Infest - 
Reforget - LAUV - 
Strobes Pt. 2 - Lemaitre - Relativity 1 - 
Lemme Freak - Lil Dicky - Professional Rapper - 
Rollin' (Air Raid Vehicle) - Limp Bizkit - 
Guren No Yumiya - Linked Horizon - 
Two of Us - Lipless - 
Vapor - Lockyn - 
Lone Digger - Caravan Palace - <|°_°|> - 
7 Years - Lukas Graham - 7 Years - 
Drunk On You - Luke Bryan - 
Shuriken - Madeon - Shuriken - 
Icarus - Madeon - Adventure - 
The City - Madeon - Adventure - 
Stay Awake - Ellie Goulding - Halcyon - 
Bullseye - KDrew - 
Emo Night - Mamang Kesbor - 
Animals - Maroon 5 - V - 
One More Night - Cascada - Everytime We Touch - 
This Love - Maroon 5 - This Love - 
Alone - Marshmello - Alone - 
Siren Song - MARUV - Siren Song - 
Sexual Healing - Marvin Gaye - 
IO.SYS - MASTER BOOT RECORD - C:\>CHKDSK /F - 
Get Em Up - Matbow - 
Sekali Lagi - Maudy Ayunda - 
Hijack - mc chris - Knowing Is Half the Hassle - 
U Can't Touch This - MC Hammer - 
Miss Decibel - Medina - 
Back on the Rocks - Mega NRG Man - SUPER EUROBEAT PRESENTS INITIAL D D SELECTION - 
Get me Power - Mega NRG Man - SUPER EUROBEAT PRESENTS INITIAL D D SELECTION - 
Red fraction - MELL - MELLSCOPE - 
All You Are - Memtrix - Voodoo EP - 
Down Under - Men At Work - 
The Safety Dance - Men Without Hats - 
Sad Story (Out Of Luck) - Merk & Kremont - 
Enter Sandman - Metallica - 
Metamorphose - RoughSketch - The Far East Hard Session - 
Kids - MGMT - 
Alive - Mind Vortex - Alive / Arc - 
Crush - Moe Shop - Pure Pure - 
Kawaii Desho - Moe Shop - Pure Pure - 
You Look So Good - Moe Shop - Pure Pure - 
Highlight - Moe Shop - 
Optinuum - Moguai - Dusk Till Doorn 2011 - 
Rays of Dawn - MoonShard - 
Outta My Mind - Monsune - Tradition - 
Spellborn - Sham Stalin - 
MTC Saga - S3RL - 
YODDHA - MujjO - 
Six Shooter - Coyote Kisses - 
Supremacy - Muse - 
Ebi (Shrimp) - MUST DIE! - Neo Tokyo EP - 
Neo Tokyo - MUST DIE! - Neo Tokyo EP - 
Onii-Chan - MUST DIE! - Neo Tokyo EP - 
Ghost - Mystery Skulls - 
TRAGEDY:ETERNITY - MYTH & ROID - eYe's - 
sunny garden sunday - MYTH & ROID - eYe's - 
Careless - NEFFEX - 
Life - NEFFEX - 
Rumors - NEFFEX - 
Into the Night - NERO - Between II Worlds - 
Satisfy - NERO - Satisfy - 
Put Your F*cking Phone Down - Nhato - HARDCORE SYNDROME X - 
How You Remind Me - Nickelback - Silver Side Up - 
Night By Night - Chromeo - 
Candy Coated Suicide - Night Club - Scary World - 
Schizophrenic - Night Club - Scary World - 
Your Addiction - Night Club - Scary World - 
Nandaka - NIVIRO - 
Nemesis (Kobaryo Remix) - Nizikawa - KNIGHTS OF THE SOUND SYSTEM - 
The Fucking Party - Noizenecio - Bright Colors 3 - 
Cocaine - Nomy - Song or Suicide - 
Awake From Dream (2017 Remake) - nora2r - NXR RECOLLECTION - 
Maybe Tonite - Norma Sheffield - SUPER EUROBEAT presents INITIAL D 〜D SELECTION 2〜 - 
1337 - NXS - 
Precious Time - Ollie Crowe - 
Heart Function - O2i3 - Kirara Anthems vol.3 - 
Hello - OMFG - 
Clock Strikes - ONE OK ROCK - 
Riot!!! - ONE OK ROCK - Niche Syndrome - 
Counting Stars - OneRepublic - 
The Beginning - ONE OK ROCK - The Beginning - 
We are - ONE OK ROCK - Ambitions - 
Colorblind - Panda Eyes - 
I Write Sins Not Tragedies - Panic! at the Disco - A Fever You Can't Sweat Out - 
High Hopes - Panic! at the Disco - Pray for the Wicked - 
crushcrushcrush - Paramore - RIOT! - 
Ignorance - Paramore - 
That's What You Get - Paramore - RIOT! - 
Misery Business - Paramore - Misery Business - 
Carried Away - Passion Pit - Gossamer - 
Take a Walk - Passion Pit - Gossamer - 
Witchcraft - Pendulum - Immersion - 
Showdown - Pendulum - In Silico - 
Girl in the Fire - Pendulum - Hold Your Colour - 
San Francisco Knights - People Under the Stairs - The Next Step - 
Miami Disco - Perturbator - 
Humans Are Such Easy Prey - Perturbator - Dangerous Days - 
Neo Tokyo - Perturbator - The Uncanny Valley - 
Pa-Pa-Pa-Pa-Pa - P*Light - YABAICORE - 
Glorious Days - P*Light - Bright Colors 4 - 
Sad Machine - Porter Robinson - 
Scorpio - pour vous - 
Coexist - Prismo - 
Bukan Superstar - Project Pop - Top Of The Pop - 
Metal vs Dugem - Project Pop - Six-a-Six - 
Propane Nightmares - Pendulum - Propane Nightmares - 
Ghost Town - TeddyLoid - Panty & Stocking with Garterbelt: THE WORST ALBUM - 
Funk Assembly - PSYQUI - Ultra Hitech 04 - 
Public Service Announcement - S3RL - 
DVP - PUP - The Dream Is Over - 
Make It Wit Chu - Queens of the Stone Age - Era Vulgaris - 
Nostalgia - Quok - 
Kiss Me - Rameses B - Essence - 
With You - Rameses B - 
Ich will - D-Flame - Stress - 
Du hast - Rammstein - Du hast - 
Sonne - Rammstein - Sonne - 
Can't Stop - Red Hot Chili Peppers - 
Come Come Power - REDALiCE - Bright Colors - 
Jumpin' Disco - REDALiCE - Bright Colors 4 - 
EUROPASS - James Shimoji - REDLINE Original Soundtrack - 
Yellow Line - James Shimoji - REDLINE Original Soundtrack - 
Let It Burn - Red - Until We Have Faces - 
Here We Go - RetroVision - 
theater D - MYTH & ROID - eYe's - 
Zombie Prom Night - Richie Beretta - 
Right Here, Right Now - Fatboy Slim - You've Come a Long Way, Baby - 
Kannata - Rocky Rock - Kannata - 
Guitar Sound - Ronald Jenkees - 
Chemicals - Rosemary Fairweather - Heavenly - 
Roundtable Rival - Lindsey Stirling - 
Out Of The Black - Royal Blood - 
YYZ - Rush - Moving Pictures - 
Aeolis - Sanaas - J-NERATION 4 - 
Jack-the-Ripper - Sasakure.UK - 
Theme for Scanty & Knee Socks - TeddyLoid - Panty & Stocking with Garterbelt: The Original Soundtrack - 
Departure - SCANDAL - Departure - 
Scary World - Night Club - Scary World - 
Flatline - Scattle - Hotline Miami: The Takedown EP - 
Inner Animal - Scattle - Hotline Miami: The Takedown EP - 
It's Safe Now - Scattle - Hotline Miami: The Takedown EP - 
To the Top - Scattle - Hotline Miami: The Takedown EP - 
Knock Knock - Scattle - Hotline Miami: The Takedown EP - 
Lithium Flower - Scott Matthew - 
Slow Down - Selena Gomez - 
Semantics - NNAMDÏ - BRAT - 
Boombastic - Shaggy - 
She Wolf - Shakira - She Wolf - 
Coloris - She - 
Dying To Meet You - She's Only Sixteen - 
Atomic - she - Orion - 
Melompat Lebih Tinggi - Sheila on 7 - 30 Hari Mencari Cinta - 
Supersonic - she - Chiptek - 
Lagi Syantik - Siti Badriah - Lagi Syantik - 
Singing In The Rain - Gene Kelly - 
My Sound - Sixtyfours - 
Giant - Skan - 
Drop Freaks - Getty - HYBRID MONSTER 2 - 
Nameless World - Skip the Use - Little Armageddon - 
I Can't Be Your Superman - Skylar Spence - Prom King - 
[covered in white] - Snail's House - Snö - 
Farewell - Snail's House - Snö - 
see you again (outro) - Snail's House - Snö - 
[fluttering] - Snail's House - Snö - 
[snowdrift] - Snail's House - Snö - 
Snö (Intro) - Snail's House - Snö - 
thaw (interlude) - Snail's House - Snö - 
[whiteout] - Snail's House - Snö - 
[waiting for you, waiting for you.] - Snail's House - Snö - 
Sons - Concorde - 
Lonely Love - Sophie - SUPER EUROBEAT presents INITIAL D 〜D SELECTION 2〜 - 
Space Boy - Dave Rodgers - SUPER EUROBEAT PRESENTS INITIAL D D SELECTION - 
Reality - Spektrel - 
For Lights - Srav3R - Bright Colors 4 - 
Blast From the Past - Stonebank - Monstercat 024: Vanguard - 
The Pressure - Stonebank - Monstercat 022: Contact - 
What's Going Down - Stonebank - What's Going Down - 
Alors on danse - Stromae - Cheese - 
Carmen - Stromae - Racine carrée - 
Papaoutai - Stromae - Papaoutai - 
Brother - Stuck in the Sound - Pursuit - 
STYX HELIX - MYTH & ROID - 
Start Again - Sub.Sound - 
Survive - Night Club - Scary World - 
ATWA - System of a Down - Toxicity - 
Chop Suey! - System of a Down - Toxicity - 
Electro - T4TSUYA - HYBRID MONSTER 3 - 
The Less I Know the Better - Tame Impala - Currents - 
We Are Never Ever Getting Back Together - Taylor Swift - 
Fly Away - TeddyLoid - Panty & Stocking with Garterbelt: The Original Soundtrack - 
Forever Love - TeddyLoid - BLACK MOON RISING - 
Slow Love - Tender - Fear of Falling Asleep - 
Fantasy - Tesla Boy - The Universe Made of Darkness - 
Holy Roller - Thao & the Get Down Stay Down - We the Common - 
My Favourite Chords - The Weakerthans - Left and Leaving - 
Parampampam - The Changcuters - Tugas Akhir - 
Zombie - The Cranberries - No Need to Argue - 
The Everlasting Guilty Crown - EGOIST - 
Booger Bear - The Floozies - 
Dendron - The Hotelier - Home, Like Noplace Is There - 
Yuve Yuve Yu - The HU - The Gereg - 
Runaways - The Killers - Direct Hits - 
Shot at the Night - The Killers - Direct Hits - 
Somebody Told Me - The Killers - Direct Hits - 
114 - The Majority Says - 
Spitfire - The Prodigy - 
The Trouble - Pogo - Kindred Shadow - 
Windfall - TheFatRat - 
Therapy (Get High) - Night Club - Scary World - 
Boot - The Algorithm - Brute Force - 
Mr. Brightside - The Killers - Hot Fuss - 
Colors - Tobu -   - 
Sweet Story - Tobu - 
BLAST - Tokyo Machine - 
It's Not Unusual - Tom Jones - It's Not Unusual - 
Break the Night - Tommy K - SUPER EUROBEAT PRESENTS INITIAL D D SELECTION - 
Africa - Toto - Toto IV - 
Do It - Tuxedo - 
Stressed Out - twenty one pilots - Blurryface - 
Heathens - twenty one pilots - Suicide Squad: The Album - 
Closer to You - Uppermost - Evolution - 
Follow Me - Tristam - 
Guidance - Urbanstep - 
Fucking High - USAO - HARDCORE SYNDROME X - 
Try again - USAO - Bright Colors 4 - 
Anchor - Tritonal - Metamorphic III - 
Merry Christmas Mr. Lawrence - FYI - Utada - This Is the One - 
Deeper - USAO - IRREGULAR NATION 3 - 
Dancing - Vicky Vale - SUPER EUROBEAT presents INITIAL D 〜D SELECTION 2〜 - 
Stay - Victoria - SUPER EUROBEAT presents INITIAL D 〜D SELECTION 2〜 - 
Pump - Valentino Khan - 
Faith - Vierratale - Faith - 
Seandainya - Vierra - My First Love - 
Dengarkan Curhatku - Vierra - My First Love - 
Shimmer - VOLO - 
Wander - VOLO - 
Vampires - Night Club - Scary World - 
With You - Virtual Riot - Throw Back - 
1612 - Vulfpeck - Fugue State - 
Crying Soul - Wayr - 
She's Lost Control - The Arkhams - The Road to Arkham - 
Jaguar - What So Not - Jaguar - 
Volt - Lockyn - 
Adrenalized - Vonikk - 
Eventide - Wisp X - 
Reminisce - Wisp X - 
Illuminate - Wisp X - 
Sparkling Tides - Wisp X - 
HAVE A NICE DAY - WORLD ORDER - HAVE A NICE DAY - 
Blue Zenith - xi - Parousia - 
Ya no sé que hacer conmigo - El Cuarteto de Nos - Raro - 
Bakamitai - Taxi Driver Edition - Kazuma Kiryu(Takaya Kuroda) - Kazuma Kiryu Karaoke hit song collection(Ryu ga gotoku7 hikari to yami no yukue) - 
Till It's Gone - Yelawolf - Till It's Gone - 
Stars (Hold On) - Youngblood Hawke - Wake Up - 
Stars (Hold On) - Youngblood Hawke - Wake Up - 
Runnin Around - Zak Waters - Lip Service - 
Destiny - Zyphen - 
Breathe - TwoThirds - Monstercat 015 - Outlook - 
Try This - Pegboard Nerds - Monstercat 022: Contact - 
Restart - Subtact - Monstercat 023: Voyage - 
Dream Soda - Televisor - Monstercat 014: Discovery - 
Stellar - Aerion - 
Source - Fever the Ghost - Crab in Honey - 
Turbo Killer - Carpenter Brut - EP III - 
Kiss My Ass - USAO - Kick's For Liberation 6 - 
Tornado Dance - DJ Shimamura - TEMPOCOP - 
Crazy Scary Holy Fantasy - MYTH & ROID - eYe's - 
Demon's Jingles - Kobaryo - TANO*C JINGLE COLLECTION - 
imp - Sakuzyo - Food and Musik - 
Sakura Fubuki - Shandy Kubota - Shandy Bass 3 - 
Toccata - OVERWERK - Toccata - 
Purge - aran - Supremacy - 
ANGER/ANGER - MYTH & ROID - eYe's - 
L.L.L. - MYTH & ROID - eYe's - 
Crystalline - CIRCRUSH - EXIT TUNES PRESENTS Entrance Dream Music - 
Peppermint - Wontolla - 
Time To Play - DJ Noriken - HYBRID MONSTER 3 - 
Memories (Do You Remember?) - Fidel Wicked - Let My Music Play - 
STYX HELIX - MYTH & ROID - STYX HELIX - 
Graces of Heaven - aran - HARDCORE SYNDROME 7 - 
Breeder - Abitan - HYBRID MONSTER 2 - 
Fake Ass Bitches - 2Pac - R U Still Down? (Remember Me) - 
Stargazer - Aether - 
Burst the Gravity - ALTIMA - Burst the Gravity - 
Furia - 7UBO - 
Brave Shine - Aimer - Brave Shine - 
Faded - Alan Walker - Faded - 
Sing Me to Sleep - Alan Walker - Sing Me to Sleep - 
Natsukashii - AHBSNT - 
Speedhunter - Alex Skrindo - 
Anvil - Lorn - Vessel - 
Willst du - Alligatoah - Triebwerke - 
Windowlicker - Aphex Twin - Windowlicker - 
Flim - Aphex Twin - Come to Daddy - 
Apocalypse - Cigarettes After Sex - Cigarettes After Sex - 
Arclight - aran - ARATOSHI - 
Emoticon - aran - Bright Colors 3 - 
Enchanted Leaf - aran - HARDCORE SYNDROME 9 - 
The Vividness of Memory - Aran - Bright Colors - 
Rock the Vox - aran - Bright Colors 2 - 
Refound - aran - IRREGULAR NATION 2 - 
Do I Wanna Know? - Arctic Monkeys - Do I Wanna Know? - 
Space Oddity - Chris Hadfield - Space Sessions: Songs From a Tin Can - 
Anubis - Brandberg - 
Avalanche - Quil - The Far East Hard Session - 
Afterlife - Avenged Sevenfold - Avenged Sevenfold - 
Nightmare - Avenged Sevenfold - Nightmare - 
Girlfriend - Avril Lavigne - The Best Damn Thing - 
Never Sober - Avenza - 
Run - AWOLNATION - Run - 
Hello Kitty - Avril Lavigne - Hello Kitty - 
Bad Karma - Axel Thesleff - Bad Karma - 
Harlem Shake - Baauer - Harlem Shake - 
KARATE - BABYMETAL - METAL RESISTANCE - 
Kaleidoscope - BADBADNOTGOOD - III - 
Saturday - Basshunter - Calling Time - 
Of the Night - Bastille - Of the Night - 
So Sweet Bitter Days - Betwixt & Between - Bright Colors - 
bad guy - Billie Eilish - WHEN WE ALL FALL ASLEEP, WHERE DO WE GO? - 
Just a Bill - Billy the Fridge - Old Fashioned - 
Heaven Is a Place on Earth - Belinda Carlisle - Heaven on Earth - 
LOGIN - AshZone - 
Eraser - Black Sun Empire - Lights and Wires - 
Black Out - Overload - SUPER EUROBEAT presents INITIAL D 〜D SELECTION 3〜 - 
Dopamine - Blackstripe - 
WOHO - Blackstripe - 
Sure Be Cool If You Did - Blake Shelton - Based on a True Story... - 
Uhn Tiss Uhn Tiss Uhn Tiss - Bloodhound Gang - Uhn Tiss Uhn Tiss Uhn Tiss - 
Blood on Your Blade - Night Club - Scary World - 
Eyes on Fire - Blue Foundation - Life of a Ghost - 
Everything You Do Is a Balloon - Boards of Canada - Hi Scores - 
Rasputin - Boney M. - The Greatest Hits - 
Border Is Nothing (Noizenecio remix) - RoughSketch - The Far East Hard Session - 
Breach - Black Sun Empire - Driving Insane - 
Blackout - Breathe Carolina - 
Shadow Moses - Bring Me the Horizon - Sempiternal - 
Break the Ice - Britney Spears - Blackout - 
Runaway Baby - Bruno Mars - Doo-Wops & Hooligans - 
Imaginary Places - Busdriver - 
Delta - C2C - 
You Used to Hold Me - Calvin Harris - Ready for the Weekend - 
Safe and Sound - Capital Cities - In a Tidal Wave of Mystery - 
Hello - Capsule - 
Dramophone - Caravan Palace - Panic - 
Miracle - Caravan Palace - Miracle - 
Wonderland - Caravan Palace - <|°_°|> - 
Everytime We Touch - Cascada - 
Release the Beast - Breakwater - Splashdown - 
Chain - Back-On - 
Catchit - S3RL - 
Ready Set Roll - Chase Rice - Ignite the Night - 
Redbone - Childish Gambino - Redbone - 
3005 - Childish Gambino - 3005 - 
Bonfire - Childish Gambino - Camp - 
The Signal - BertycoX - The Signal - 
Bubble Dream - CHON - 
Genie in a Bottle - Christina Aguilera - Christina Aguilera - 
Sakitnya Tuh Disini - Cita Citata - Sakitnya Tuh Disini - 
Story - CHON - 
Lord of the Dance - Chris Clark - 
Ohmygodiloveyoupleasedontleaveme - Clever Girl - 
Haven - Clarx - 
Clouds - Zach Sobiech - Clouds - 
Hello Bitches - CL - Hello Bitches - 
Every Teardrop Is a Waterfall - Coldplay - Every Teardrop Is a Waterfall - 
Fortunate Son - Creedence Clearwater Revival - 
Overcharge - crt_head - Power Up - 
Koto - CloZee - Koto - 
Sofia - Clairo - Immunity - 
Crush - Cigarettes After Sex - Crush - 
Impacto - Daddy Yankee - El Cartel: The Big Boss - 
C.U.R.E. - BOOTS - AQUARIA - 
Aerodynamic - Daft Punk - Discovery - 
Crescendolls - Daft Punk - Discovery - 
End of Line - Daft Punk - TRON: Legacy - 
One More Time / Aerodynamic - Daft Punk - Alive 2007 - 
Da Funk - Daft Punk - Homework - 
Face to Face - Daft Punk - Discovery - 
One More Time - Daft Punk - Discovery - 
Something About Us - Daft Punk - Discovery - 
Voyager - Daft Punk - Discovery - 
Television Rules the Nation - Daft Punk - Human After All - 
Veridis Quo - Daft Punk - Discovery - 
Daisuke - El Huervo - Do Not Lay Waste to Homes... - 
Dancing in the Moonlight - Toploader - Onka's Big Moka - 
Beat of the Rising Sun - Dave Rodgers - SUPER EUROBEAT presents INITIAL D 〜D SELECTION 3〜 - 
Boom Boom Japan - Dave Rodgers - SUPER EUROBEAT presents INITIAL D 〜D SELECTION 3〜 - 
Saturday Night Fever - Dave Rodgers - SUPER EUROBEAT presents INITIAL D 〜D SELECTION 3〜 - 
I Need Your Love - Dave Simon - SUPER EUROBEAT presents INITIAL D 〜D SELECTION 2〜 - 
Just Girly Things - Dawin - 
The Alphabeat - David Guetta - Nothing but the Beat - 
Sirensong - Decemberkid & Ken Raka - 
Tunak Tunak Tun - Daler Mehndi - Tunak Tunak Tun - 
Phantom Killer - DJ Myosuke - STORYTELLER VOLUME 1 - 
Bassline Disco - DJ Noriken - RADIANCE - 
Drive My Car - DEAMN - 
Be All Out (Enraged_3x3) - DJ Noriken - Hybrid Monster - 
Taurus (Fatal Attack) - DJ Noriken - ZODIAX EP - 
Flower Dance - DJ Okawari - A Cup Of Coffee - 
Luv Letter - DJ Okawari - Libyus Music Sound History 2004-2010 - 
(Make Some Noize) Smack My Rave - DJ Shimamura - MAX - 
STOMP the Showtime - DJ Laugh - Bright Colors 2 - 
Randomize to Euphoria - DJ Noriken - Bright Colors - 
Elektrikshot - DJ Noriken - ABSOLUTE - 
White Flag - Delta Heavy - Paradise Lost - 
Tonight, Alright - DJ Noriken - YABAICORE - 
F33L 1T - DJ Noriken - HARDCORE SYNDROME X - 
U Bring Me Joy - DJ Shimamura - Bright Colors 4 - 
F33L 1T (Getty Remix) - DJ Noriken - Resurrection X - 
Battle Cry - DotEXE - Monstercat 018: Frontier - 
What's The Difference - Dr. Dre - 2001 - 
X Gon' Give It To Ya - DMX - 
Boogie Wonderland - Earth, Wind & Fire - The Great Earth, Wind & Fire - 
September - Earth, Wind & Fire - The Best of Earth, Wind & Fire, Volume 1 - 
Let's Groove - Earth, Wind & Fire - 
Don't Stop Believin' - Journey - Revelation - 
Galway Girl - Ed Sheeran - ÷ - 
Departure - Ed Harrison - 
Shape of You - Ed Sheeran - ÷ - 
Regain Control - Shirobon - Distant Reality - 
Lost Into the Night - ELISA - SUPER EUROBEAT presents INITIAL D 〜D SELECTION 2〜 - 
Bully - Fusk Asker - 
Rap God - Eminem - The Marshall Mathers LP 2 - 
Pneumatic Tokyo - EnV - 
Eolian Oms - Jade Cicada - 
Вите надо выйти - Estradarada - Дискотека века - 
This Ain't a Scene, It's an Arms Race - Fall Out Boy - Infinity on High - 
Wings - EDEN - 
Falling in Love - Cigarettes After Sex - Falling in Love - 
Handlebars - Flobots - Handlebars - 
Fast Car - Tracy Chapman - Tracy Chapman - 
The Pretender - Foo Fighters - Greatest Hits - 
Waiting for a Girl Like You - Foreigner - 
COLORS - FLOW - COLORS - 
Don't Stop (Color on the Walls) - Foster the People - Torches - 
Hometown - French 79 - Joshua - 
Stacy's Mom - Fountains of Wayne - Stacy's Mom - 
Cutie Cutie - Fusq - 
Centuries - Fall Out Boy - 
New World - iMeiden - 
Don't Fake The Funk. - Funklow. - 
MIRAI - GARNiDELiA - MIRAI - 
Black - GAZIROVKA - NEBOBLAKA - 
Perfume! - Fusq - 
Blaze - Getty - YABAICORE - 
Doggy Tails - Getty - J-NERATION TOYS - 
GHOST IN THE SHELL ARISE - Cornelius - 攻殻機動隊ARISE O.S.T. - 
Raving Hype - Getty - HARDCORE SYNDROME 12 - 
Weather - Ginger Root - Weather - 
Ghost in the Shell Arise - Cornelius - 
Once Again - Girl Talk - Night Ripper - 
King Taco - Goblins From Mars - Vol. 2 (Originals) - 
Casin - glue70 - 
nhk!? - goreshit - my love feels all wrong - 
o'er the flood - goreshit - semantic compositions on death and its meaning - 
19-2000 - Gorillaz - Gorillaz - 
MATZcore - goreshit - my love feels all wrong - 
the nature of dying - goreshit - semantic compositions on death and its meaning - 
Dirty Harry - Gorillaz - Dirty Harry - 
On Melancholy Hill - Gorillaz - Plastic Beach - 
Kay-LynnX10 - Goth Von Core - 
Clint Eastwood - Gorillaz - Gorillaz - 
21 Guns - Green Day - 21st Century Breakdown - 
Мальчик Party - GRIVINA - Танцую одна - 
Halcyon - xi - Parousia - 
U Got That - Halogen - U Got That - 
Mountains - Hans Zimmer - Interstellar - 
No Time for Caution - Hans Zimmer - Interstellar - 
Schweine - Glukoza - 
Day One - Hans Zimmer - Interstellar - 
Salty Hyperlaser - DJ NECOJITA - J-NERATION 6 - 
Ouija - Harley Poe - Satan, Sex and No Regrets - 
Galaxxxy_Burst - DJ Shimamura - HARDCORE SYNDROME 5 - 
narkotik kal - Hard Bass School - 
Crank It Up - HI-LO - 
Should Have Known Better - Hinder - Welcome to the Freakshow - 
HeavenZ-ArmZ - sasakure.UK - 
Indigo Blossom - Hoverboots - 
SpaceJellyfish - クラゲ - HoneyComeBear - 
Mutual - HVNNIBVL - 
I Don't Want to Set the World on Fire - The Ink Spots - The Anthology - 
Pop Culture - Icon for Hire - Icon for Hire - 
Illusion (instrumental) - Approaching Nirvana - Illusions - 
Imma Be A Raver - Yultron - 
Imaginary Friend - Night Club - Scary World - 
Don't Stop the Music - Lou Grant - SUPER EUROBEAT PRESENTS INITIAL D D SELECTION - 
No One Sleep in Tokyo - Edo Boys - SUPER EUROBEAT PRESENTS INITIAL D D SELECTION - 
Hide and Seek - Imogen Heap - Hide and Seek - 
Spark in the Dark - Man Power - SUPER EUROBEAT PRESENTS INITIAL D D SELECTION - 
First Step - Hans Zimmer - Interstellar: Original Motion Picture Soundtrack - 
Everybody's Warming - Tension - SUPER EUROBEAT presents INITIAL D 〜D SELECTION 2〜 - 
Cluster A - in the blue shirt - Cyanotype - 
Alga - IGNEA - The Sign of Faith - 
Tick-Tock - Hans Zimmer - Interstellar - 
Keep Being You - Isyana Sarasvati - Explore! - 
SOLOMON - Yooh - ABSOLUTE - 
Ceria - J-Rocks - 
Jenny - Studio Killers - Studio Killers - 
Be My Babe - Jilly - SUPER EUROBEAT PRESENTS INITIAL D D SELECTION - 
SLOW DANCING IN THE DARK - Joji - BALLADS 1 - 
Genesis - Justice - ✝ - 
In the End - Linkin Park - Hybrid Theory - 
I'm Not Racist - Joyner Lucas - I'm Not Racist - 
Waters of Nazareth - Justice - ✝ - 
La camisa negra - Juanes - Mi sangre - 
Carry on Wayward Son - Kansas - Mullets Rock! - 
K. - Cigarettes After Sex - Cigarettes After Sex - 
Julia - Kaosic - 
Flavour - Itro - 
E.T. - Katy Perry - Teenage Dream - 
Good Morning - Kanye West - Graduation - 
Absolute Territory - Ken Ashcorp - Absolute Territory - 
We're Shameless - Ken Ashcorp - 
Bullseye - KDrew - 
Swimming Pools (Drank) - Kendrick Lamar - 
ListEN to my fuckiNg shit - kenta-v.ez. - Bright Colors 2 - 
A New Day Dawns - Kero One - 
shAdow brEAk - kenta-v.ez. - Bright Colors 3 - 
Roadgame - Kavinsky - OutRun - 
The Illness - Kid606 - 
Gold - Kiiara - Low Kii Savage - 
Tennessee - Kiiara - Low Kii Savage - 
Summer Daze - Kill Paris - Galaxies Between Us - 
Feels - Kiiara - Low Kii Savage - 
Undressed - Kim Cesarion - Undressed - 
Kill The Deadline - Hommarju - We Are Connected - 
Tool-Assisted Speedcore - Kobaryo - The Psycho Blast Vol.1  - 
Dancing Queen - King & Queen - SUPER EUROBEAT presents INITIAL D 〜D SELECTION 2〜 - 
Into the Labyrinth - Kraddy - Labyrinth - 
That's Where It All Started - Kognitif - Soul Food - 
Be There - Krewella - Be There - 
Bonfire - Knife Party - Rage Valley - 
Broken Record - Krewella - Ammunition - 
Thé à la menthe - La Caution - Peines de maures - 
LoveGame - Lady Gaga - The Fame - 
Thé à la menthe - La Caution - 
Last Resort - Papa Roach - Infest - 
Strobes Pt. 2 - Lemaitre - Relativity 1 - 
Lemme Freak - Lil Dicky - Professional Rapper - 
Paparazzi - Lady Gaga - 
Reforget - LAUV - 
Guren No Yumiya - Linked Horizon - 
Rollin' (Air Raid Vehicle) - Limp Bizkit - 
Vapor - Lockyn - 
Lone Digger - Caravan Palace - <|°_°|> - 
Two of Us - Lipless - 
Drunk On You - Luke Bryan - 
Icarus - Madeon - Adventure - 
The City - Madeon - Adventure - 
Stay Awake - Ellie Goulding - Halcyon - 
7 Years - Lukas Graham - 7 Years - 
Animals - Maroon 5 - V - 
Emo Night - Mamang Kesbor - 
Shuriken - Madeon - Shuriken - 
Alone - Marshmello - Alone - 
This Love - Maroon 5 - This Love - 
Siren Song - MARUV - Siren Song - 
One More Night - Cascada - Everytime We Touch - 
IO.SYS - MASTER BOOT RECORD - C:\>CHKDSK /F - 
Sekali Lagi - Maudy Ayunda - 
Sexual Healing - Marvin Gaye - 
Hijack - mc chris - Knowing Is Half the Hassle - 
Get Em Up - Matbow - 
Miss Decibel - Medina - 
Back on the Rocks - Mega NRG Man - SUPER EUROBEAT PRESENTS INITIAL D D SELECTION - 
Red fraction - MELL - MELLSCOPE - 
Get me Power - Mega NRG Man - SUPER EUROBEAT PRESENTS INITIAL D D SELECTION - 
Down Under - Men At Work - 
U Can't Touch This - MC Hammer - 
The Safety Dance - Men Without Hats - 
Sad Story (Out Of Luck) - Merk & Kremont - 
Enter Sandman - Metallica - 
Metamorphose - RoughSketch - The Far East Hard Session - 
Crush - Moe Shop - Pure Pure - 
All You Are - Memtrix - Voodoo EP - 
Alive - Mind Vortex - Alive / Arc - 
Kawaii Desho - Moe Shop - Pure Pure - 
You Look So Good - Moe Shop - Pure Pure - 
Optinuum - Moguai - Dusk Till Doorn 2011 - 
Outta My Mind - Monsune - Tradition - 
Highlight - Moe Shop - 
Spellborn - Sham Stalin - 
YODDHA - MujjO - 
MTC Saga - S3RL - 
Supremacy - Muse - 
Six Shooter - Coyote Kisses - 
Ebi (Shrimp) - MUST DIE! - Neo Tokyo EP - 
Neo Tokyo - MUST DIE! - Neo Tokyo EP - 
Onii-Chan - MUST DIE! - Neo Tokyo EP - 
Paralyzed - Mystery Skulls - 
Ghost - Mystery Skulls - 
TRAGEDY:ETERNITY - MYTH & ROID - eYe's - 
sunny garden sunday - MYTH & ROID - eYe's - 
Careless - NEFFEX - 
Life - NEFFEX - 
Into the Night - NERO - Between II Worlds - 
Rumors - NEFFEX - 
Satisfy - NERO - Satisfy - 
Put Your F*cking Phone Down - Nhato - HARDCORE SYNDROME X - 
How You Remind Me - Nickelback - Silver Side Up - 
Kids - MGMT - 
Schizophrenic - Night Club - Scary World - 
Your Addiction - Night Club - Scary World - 
Candy Coated Suicide - Night Club - Scary World - 
Nemesis (Kobaryo Remix) - Nizikawa - KNIGHTS OF THE SOUND SYSTEM - 
The Fucking Party - Noizenecio - Bright Colors 3 - 
Cocaine - Nomy - Song or Suicide - 
Night By Night - Chromeo - 
Awake From Dream (2017 Remake) - nora2r - NXR RECOLLECTION - 
Maybe Tonite - Norma Sheffield - SUPER EUROBEAT presents INITIAL D 〜D SELECTION 2〜 - 
Heart Function - O2i3 - Kirara Anthems vol.3 - 
Nandaka - NIVIRO - 
Precious Time - Ollie Crowe - 
Hello - OMFG - 
Clock Strikes - ONE OK ROCK - 
Counting Stars - OneRepublic - 
Riot!!! - ONE OK ROCK - Niche Syndrome - 
The Beginning - ONE OK ROCK - The Beginning - 
Colorblind - Panda Eyes - 
We are - ONE OK ROCK - Ambitions - 
I Write Sins Not Tragedies - Panic! at the Disco - A Fever You Can't Sweat Out - 
crushcrushcrush - Paramore - RIOT! - 
High Hopes - Panic! at the Disco - Pray for the Wicked - 
Ignorance - Paramore - 
Misery Business - Paramore - Misery Business - 
That's What You Get - Paramore - RIOT! - 
Take a Walk - Passion Pit - Gossamer - 
Carried Away - Passion Pit - Gossamer - 
Showdown - Pendulum - In Silico - 
Witchcraft - Pendulum - Immersion - 
Girl in the Fire - Pendulum - Hold Your Colour - 
San Francisco Knights - People Under the Stairs - The Next Step - 
Humans Are Such Easy Prey - Perturbator - Dangerous Days - 
Neo Tokyo - Perturbator - The Uncanny Valley - 
Miami Disco - Perturbator - 
Pa-Pa-Pa-Pa-Pa - P*Light - YABAICORE - 
Glorious Days - P*Light - Bright Colors 4 - 
Scorpio - pour vous - 
Sad Machine - Porter Robinson - 
Bukan Superstar - Project Pop - Top Of The Pop - 
Coexist - Prismo - 
Metal vs Dugem - Project Pop - Six-a-Six - 
Propane Nightmares - Pendulum - Propane Nightmares - 
Ghost Town - TeddyLoid - Panty & Stocking with Garterbelt: THE WORST ALBUM - 
Public Service Announcement - S3RL - 
Funk Assembly - PSYQUI - Ultra Hitech 04 - 
DVP - PUP - The Dream Is Over - 
Make It Wit Chu - Queens of the Stone Age - Era Vulgaris - 
1337 - NXS - 
Nostalgia - Quok - 
Ich will - D-Flame - Stress - 
Kiss Me - Rameses B - Essence - 
Sonne - Rammstein - Sonne - 
Du hast - Rammstein - Du hast - 
Can't Stop - Red Hot Chili Peppers - 
Come Come Power - REDALiCE - Bright Colors - 
EUROPASS - James Shimoji - REDLINE Original Soundtrack - 
With You - Rameses B - 
Yellow Line - James Shimoji - REDLINE Original Soundtrack - 
theater D - MYTH & ROID - eYe's - 
Jumpin' Disco - REDALiCE - Bright Colors 4 - 
Let It Burn - Red - Until We Have Faces - 
Zombie Prom Night - Richie Beretta - 
Right Here, Right Now - Fatboy Slim - You've Come a Long Way, Baby - 
Kannata - Rocky Rock - Kannata - 
Chemicals - Rosemary Fairweather - Heavenly - 
Roundtable Rival - Lindsey Stirling - 
Guitar Sound - Ronald Jenkees - 
Out Of The Black - Royal Blood - 
Aeolis - Sanaas - J-NERATION 4 - 
Here We Go - RetroVision - 
Jack-the-Ripper - Sasakure.UK - 
Theme for Scanty & Knee Socks - TeddyLoid - Panty & Stocking with Garterbelt: The Original Soundtrack - 
Scary World - Night Club - Scary World - 
Flatline - Scattle - Hotline Miami: The Takedown EP - 
Inner Animal - Scattle - Hotline Miami: The Takedown EP - 
It's Safe Now - Scattle - Hotline Miami: The Takedown EP - 
Knock Knock - Scattle - Hotline Miami: The Takedown EP - 
To the Top - Scattle - Hotline Miami: The Takedown EP - 
Lithium Flower - Scott Matthew - 
Departure - SCANDAL - Departure - 
Semantics - NNAMDÏ - BRAT - 
Slow Down - Selena Gomez - 
She Wolf - Shakira - She Wolf - 
Atomic - she - Orion - 
Coloris - She - 
Boombastic - Shaggy - 
Dying To Meet You - She's Only Sixteen - 
Melompat Lebih Tinggi - Sheila on 7 - 30 Hari Mencari Cinta - 
Supersonic - she - Chiptek - 
YYZ - Rush - Moving Pictures - 
My Sound - Sixtyfours - 
Singing In The Rain - Gene Kelly - 
Lagi Syantik - Siti Badriah - Lagi Syantik - 
Nameless World - Skip the Use - Little Armageddon - 
I Can't Be Your Superman - Skylar Spence - Prom King - 
Giant - Skan - 
Butterfly - Smile - Smile - 
[covered in white] - Snail's House - Snö - 
Drop Freaks - Getty - HYBRID MONSTER 2 - 
[fluttering] - Snail's House - Snö - 
see you again (outro) - Snail's House - Snö - 
Snö (Intro) - Snail's House - Snö - 
[waiting for you, waiting for you.] - Snail's House - Snö - 
thaw (interlude) - Snail's House - Snö - 
Sons - Concorde - 
Farewell - Snail's House - Snö - 
Lonely Love - Sophie - SUPER EUROBEAT presents INITIAL D 〜D SELECTION 2〜 - 
Space Boy - Dave Rodgers - SUPER EUROBEAT PRESENTS INITIAL D D SELECTION - 
[snowdrift] - Snail's House - Snö - 
For Lights - Srav3R - Bright Colors 4 - 
Blast From the Past - Stonebank - Monstercat 024: Vanguard - 
The Pressure - Stonebank - Monstercat 022: Contact - 
What's Going Down - Stonebank - What's Going Down - 
Alors on danse - Stromae - Cheese - 
Carmen - Stromae - Racine carrée - 
Papaoutai - Stromae - Papaoutai - 
Brother - Stuck in the Sound - Pursuit - 
Start Again - Sub.Sound - 
Survive - Night Club - Scary World - 
STYX HELIX - MYTH & ROID - 
[whiteout] - Snail's House - Snö - 
Chop Suey! - System of a Down - Toxicity - 
The Less I Know the Better - Tame Impala - Currents - 
We Are Never Ever Getting Back Together - Taylor Swift - 
Fly Away - TeddyLoid - Panty & Stocking with Garterbelt: The Original Soundtrack - 
Forever Love - TeddyLoid - BLACK MOON RISING - 
Slow Love - Tender - Fear of Falling Asleep - 
Fantasy - Tesla Boy - The Universe Made of Darkness - 
Holy Roller - Thao & the Get Down Stay Down - We the Common - 
My Favourite Chords - The Weakerthans - Left and Leaving - 
Parampampam - The Changcuters - Tugas Akhir - 
Zombie - The Cranberries - No Need to Argue - 
Electro - T4TSUYA - HYBRID MONSTER 3 - 
The Everlasting Guilty Crown - EGOIST - 
ATWA - System of a Down - Toxicity - 
Booger Bear - The Floozies - 
Yuve Yuve Yu - The HU - The Gereg - 
Dendron - The Hotelier - Home, Like Noplace Is There - 
Runaways - The Killers - Direct Hits - 
Shot at the Night - The Killers - Direct Hits - 
114 - The Majority Says - 
Somebody Told Me - The Killers - Direct Hits - 
The Trouble - Pogo - Kindred Shadow - 
Reality - Spektrel - 
Therapy (Get High) - Night Club - Scary World - 
Boot - The Algorithm - Brute Force - 
Mr. Brightside - The Killers - Hot Fuss - 
Colors - Tobu -   - 
Sweet Story - Tobu - 
BLAST - Tokyo Machine - 
It's Not Unusual - Tom Jones - It's Not Unusual - 
Windfall - TheFatRat - 
Africa - Toto - Toto IV - 
Follow Me - Tristam - 
Anchor - Tritonal - Metamorphic III - 
Do It - Tuxedo - 
Stressed Out - twenty one pilots - Blurryface - 
Heathens - twenty one pilots - Suicide Squad: The Album - 
Break the Night - Tommy K - SUPER EUROBEAT PRESENTS INITIAL D D SELECTION - 
Deeper - USAO - IRREGULAR NATION 3 - 
Closer to You - Uppermost - Evolution - 
Guidance - Urbanstep - 
Try again - USAO - Bright Colors 4 - 
Fucking High - USAO - HARDCORE SYNDROME X - 
Merry Christmas Mr. Lawrence - FYI - Utada - This Is the One - 
Dancing - Vicky Vale - SUPER EUROBEAT presents INITIAL D 〜D SELECTION 2〜 - 
Stay - Victoria - SUPER EUROBEAT presents INITIAL D 〜D SELECTION 2〜 - 
Dengarkan Curhatku - Vierra - My First Love - 
Faith - Vierratale - Faith - 
Seandainya - Vierra - My First Love - 
With You - Virtual Riot - Throw Back - 
Vampires - Night Club - Scary World - 
Shimmer - VOLO - 
Volt - Lockyn - 
Pump - Valentino Khan - 
1612 - Vulfpeck - Fugue State - 
Wander - VOLO - 
Crying Soul - Wayr - 
She's Lost Control - The Arkhams - The Road to Arkham - 
Reminisce - Wisp X - 
Jaguar - What So Not - Jaguar - 
Eventide - Wisp X - 
Adrenalized - Vonikk - 
Sparkling Tides - Wisp X - 
HAVE A NICE DAY - WORLD ORDER - HAVE A NICE DAY - 
Peppermint - Wontolla - 
Blue Zenith - xi - Parousia - 
Ya no sé que hacer conmigo - El Cuarteto de Nos - Raro - 
Bakamitai - Taxi Driver Edition - Kazuma Kiryu(Takaya Kuroda) - Kazuma Kiryu Karaoke hit song collection(Ryu ga gotoku7 hikari to yami no yukue) - 
Stars (Hold On) - Youngblood Hawke - Wake Up - 
Illuminate - Wisp X - 
Stars (Hold On) - Youngblood Hawke - Wake Up - 
Destiny - Zyphen - 
Runnin Around - Zak Waters - Lip Service - 
Breathe - TwoThirds - Monstercat 015 - Outlook - 
Till It's Gone - Yelawolf - Till It's Gone - 
Try This - Pegboard Nerds - Monstercat 022: Contact - 
Stellar - Aerion - 
Restart - Subtact - Monstercat 023: Voyage - 
Source - Fever the Ghost - Crab in Honey - 
Dream Soda - Televisor - Monstercat 014: Discovery - 
Turbo Killer - Carpenter Brut - EP III - 
Kiss My Ass - USAO - Kick's For Liberation 6 - 
Crazy Scary Holy Fantasy - MYTH & ROID - eYe's - 
Demon's Jingles - Kobaryo - TANO*C JINGLE COLLECTION - 
Sakura Fubuki - Shandy Kubota - Shandy Bass 3 - 
Tornado Dance - DJ Shimamura - TEMPOCOP - 
Purge - aran - Supremacy - 
Toccata - OVERWERK - Toccata - 
ANGER/ANGER - MYTH & ROID - eYe's - 
L.L.L. - MYTH & ROID - eYe's - 
Crystalline - CIRCRUSH - EXIT TUNES PRESENTS Entrance Dream Music - 
imp - Sakuzyo - Food and Musik - 
