AiAe - DJ'TEKINA//SOMETHING - 
+♂ - Reol (れをる) - 
Digital Kecak No.5 (Remo-Con Remix Radio Edit) - DJ TECHNORCH - 円 - 
Flying - ill.Gates and Stephan Jacobs feat. Jackie Rain - Terminally Ill - 
Die - Jeff Williams and Casey Lee Williams - RWBY: Volume 2 Soundtrack - 

Dream Come True - Jeff Williams and Casey Lee Williams - RWBY: Volume 2 Soundtrack - 
Caffeine - Jeff Williams and Casey Lee Williams (feat. Lamar Hall) - RWBY: Volume 2 Soundtrack - 
All Our Days - Jeff Williams and Casey Lee Williams - RWBY: Volume 2 Soundtrack - 
Boop - Jeff Williams and Casey Lee Williams - RWBY: Volume 2 Soundtrack - 
I Burn - Jeff Williams (feat. Casey Lee Williams & Lamar Hall) - RWBY: Volume 1 Soundtrack - 
I May Fall - Jeff Williams feat. Casey Lee Williams - RWBY Volume 1 Soundtrack - 
Sacrifice - Jeff Williams and Casey Lee Williams - RWBY: Volume 2 Soundtrack - 
Red Like Roses - Part II - Jeff Williams (feat. Casey Lee Williams & Sandy Casey) - RWBY: Volume 1 Soundtrack - 
This Will Be the Day (Acoustic) - Jeff Williams and Casey Lee Williams - RWBY: Volume 2 Soundtrack - 
Time to Say Goodbye (James Landino's Beach Bae Remix) - Jeff Williams and Casey Lee Williams - RWBY: Volume 2 Soundtrack - 
Wings - Jeff Williams (feat. Casey Lee Williams) - RWBY: Volume 1 Soundtrack - 
some other time - Yoko Kanno - Ghost in the Shell STAND ALONE COMPLEX CD-BOX - 
monochrome - Ilaria Graziano - Ghost in the Shell STAND ALONE COMPLEX CD-BOX - 
Ikazuchi - Saradisk - 
20 Percent Cooler - Alex S. - Emotions of Note - 
Fallen Angel / [unknown] - Mitsunori Ikeda feat. Aimee B / [unknown] - Panty & Stocking with Garterbelt: The Original Soundtrack - 
Happy Life (ハッピーライフ) - nicamoq (にかもきゅ) - はいぱぁ電波これくしょん! ファンタスティック★大和編 - 
California Love - 2Pac - 2Pac Special - 
Fake Ass Bitches (OG) - 2Pac - R U Still Down? [Remember Me] - 
2 HAL 9000 - sasakure.UK feat. lasah - INNOCENCE - 
Die Die Die! - Widdly 2 Diddly - LISA Soundtrack - 
Moonsetter - Toby "Radiation" Fox feat. Samm Neiland & Clark Powell - Homestuck, Volume 9 - 
where does this ocean go? - Ilaria Graziano - Ghost in the Shell STAND ALONE COMPLEX CD-BOX - 
Sweet Devil - Hachioji-P/8#Prince feat. Hatsune Miku (初音ミク) - 初音ミク-Project DIVA- Ƒ Complete Collection - 
velveteen - Ilaria Graziano - Ghost in the Shell STAND ALONE COMPLEX CD-BOX - 
A Cruel Angel's Thesis (残酷な天使のテーゼ) 2009 VERSION - Yoko Takahashi (高橋洋子) - 残酷な天使のテーゼ 2009 VERSION - 
Definition of a Rap Flow - A-F-R-O - Definition of a Rap Flow - 
Take on Me - a-ha - 101 80s Hits - 
Dancin' (Krono extended mix) - Aaron Smith feat. Luvli - Chilled House, Session 7 - 
I Don't Trust You - Abitan - HARD STATION COMPILATION SEASON 1 - 
ABZ Asian BoyZ - Sicco Blue - 
Acid Rain - Lorn - The Maze to Nowhere, Part 2 - 
Highway to Hell - AC/DC - Greatest Hits: Platinum Collection '2003 - 
Thunderstruck - AC/DC - AC/DC Gold 2000 - 
Aero Dynamik - Kraftwerk - Wipeout Pulse - 
Impulse - Aesthetik - 
Aests - fight - 
Koi Wa Shita No Wa (恋をしたのは) - aiko - 恋をしたのは - 
銀河鉄道のペンギン (Stripe.P Remix) - Aiobahn & Yunomi feat. nicamoq - 
Towa no Utage (永久の宴) - Aiobahn w/ YUC'e (ゆーしえ) - Märchen EP - 
Alone in Kyoto - Air - Lost in Translation: Music From the Motion Picture Soundtrack - 
Parfait - Aire - POPOVER+TEATIME 3 - 
エアーマンが倒せない - Team.ねこかん[猫] - CDで聞いてみて。〜ニコニコ動画せれくちょん〜 - 
あいぞめ - 能登麻美子 - 地獄少女 二籠 オリジナルサウンドトラック - 
Ai Ai Ai ni Utarete Bye Bye Bye - Flow - 
Dårhus / När solen går ner - Aki feat. Kapten Röd - När solen går ner - 
海色(みいろ)  - AKINO from bless4 - 海色 - 
Don't Matter - Akon - Radio 538 Hitzone 42 - 
Alone - Alan Walker - Alone - 

Destination Calabria - Alex Gaudino feat. Crystal Waters - Destination Calabria - 
Party With Pinkie (The Living Tombstone's Remix) - Alex S. - 
Lollipop (Param Pam Pam) - Alexandra Stan - Saxobeats (deluxe edition) - 
Mr. Saxobeat - Alexandra Stan - Mr. Saxobeat - 
KawaiiStep - Alex Skrindo and Geoxor - 
Poison - Alice Cooper - No More Mr Nice Guy Live - 
Smooth Criminal (live in Denver) - Alien Ant Farm - Up in the Attic - 
U Don't Know (Just a Gent Remix) - Alison Wonderland feat. Wayne Coyne - U Don't Know - 
U Don't Know - Alison Wonderland feat. Wayne Coyne - U Don't Know - 
Allowance - Doll.ia - 
秘蜜 ~黒の誓い~ - ひとしずくP feat. 鏡音リン・鏡音レン - EXIT TUNES PRESENTS Vocalonexus - 
I'm In Control (SAINT WKND Remix) - Aluna George - 
Zombie Killer - Amsterdam Station - 
Yours Truly, - Andrew Luce - 
super anime groove 3d world - android52 - android52 presents WELCOME NEW GALAXY - 
Stardust - android52 - 52 days of autumn - 
Animal Parade - MUST DIE! - Never Say Die, Volume 4 - 
Anima Libera (Strong Edit) - Emi - 
Dia - Anji - Dia - 
Remember Summer Days (マクロスMACROSS 82-99 Bootleg) - Anri - 
Distant - ANTI-HERO and Atura - 
Distant (Sekai Remix) - ANTI-HERO and Atura - 
artcore JINJA - An - 
Boom Shack-a-lack - Apache Indian - One World - 
Girl/Boy Song (33.3 rpm) Slowed Down - Aphex Twin - 
Distant Horizon - aran feat. Kanae Asaba - ARCHVS - 
Fragment Of Crystal - aran - Round Up Crystals EP - 
GRiDGALAXY - aran - ARCHVS - 
Hyperdawn - aran - TRI▼FORCE - 
Ripples (DJ Noriken Remix) - aran - Unitone PHASE: Remixes - 
Moonbound - aran feat. yukacco - α [alpha] - 
KALACAKLA - aran & lapix - ARCHVS - 
Brianstorm - Arctic Monkeys - Brianstorm - 
R U Mine? - Arctic Monkeys - Gilmore Girls: The Ultimate Soundtrack, Volume 3 - 
Arctic Monkeys Vs Dr Dre & Eminem (Curtis Jones Mashup) - Arctic Monkeys, Dr Dre, and Eminem - 
Everyday - Ariana Grande feat. Future - Dangerous Woman - 
Evoke - ARSNL - 
Maybe - Aṣa - Beautiful Imperfection - 
Preacher Man - Aṣa - Beautiful Imperfection - 
Nanatsu Issensakura - A.saka - 
Kyoto - aso. - 
Seasons (Multi Remix) - Aso - 
Boo Hoo [Remastered] - Assertive Fluttershy - Theory of Pony - 
Around the World (La La La La La) - ATC - Around the World (La La La La La) - 
Bat Country - Avenged Sevenfold - All Excess - 
Hey Brother - Avicii - Now That's What I Call Running 2014 - 
Levels - Avicii - Joey Essex Presents Essex Anthems - 
Silhouettes - Avicii - F*** Me I'm Famous! Ibiza Mix 2012 - 
I Could Be the One - Nicktim - Avicii vs. Nicky Romero - Fun Radio: Summer Dance 2013 - 
Beautiful Lies VIP - B-Complex - Hospitality Drum & Bass 2010 - 
Crying Soul (DJ Splash Remix) - B0UNC3 - Single - 
Megitsune - BABYMETAL - Here's the Metal: July 2015 - 
Akatsuki (紅月アカツキ) - BABYMETAL - Live at Budokan - 
Ijime, Dame, Zettai (イジメ、ダメ、ゼッタイ) - BABYMETAL - BABYMETAL - 
Gimme Chocolate!! (ギミチョコ!!) - BABYMETAL - BABYMETAL - 
Doki Doki ☆ Morning (ド・キ・ド・キ☆モーニング) - BABYMETAL - BABYMETAL - 
Bad Apple!! - Alstroemeria Records feat. nomico - Lovelight - 
Bad Luck Charm - Jeff Williams - RWBY: Volume 4 Soundtrack - 
Kaleidoscope (Kaytranada's Flip) - BADBADNOTGOOD - 
Title Theme / Saria's Song / Song of Storms - BADBADNOTGOOD - BBNG - 
Bad Apple!! (Lizz English Cover) - Alstroemeria Records - 
Guns at Dawn - Baron feat. Pendulum - Guns at Dawn / Ratpack - 
Never Say Never - Basement Jaxx feat. ETML - Junto - 
Good Luck - Basement Jaxx feat. Lisa Kekaula - Good Luck - 
Good Luck - Basement Jaxx feat. Lisa Kekaula - Kish Kash - 
Bass Slut - S3RL - 
Vi sitter i Ventrilo och spelar DotA - Basshunter - LOL <(^^,)> - 
All I Ever Wanted (Radio Edit) - Basshunter - All I Ever Wanted - 
Now You're Gone - Basshunter feat. DJ Mental Theo's Bazzheadz - Now You're Gone: The Album - 
Mama (Мама) - Basta (Баста) - Баста I - 
Again and Again - Basto! - NRJ Hit Music Only! 2012 - 
Beautiful Lies ( DnB Step ) (Remix) - B-Complex - 
BEAUTIFUL WORLD - Kikuo (きくお) feat. lasah - INNOCENCE - 
Satisfaction - Benny Benassi presents The Biz - Absolute Dance: Move Your Body, Volume 2 - 
Cinema - Benny Benassi feat. Gary Go - 
Zombie - Besomorph and N3WPORT feat. Whoshafee - 
Better Off Alone (radio edit) - Alice DeeJay - Better Off Alone - 
Betty Boop - Harald Kindseth - 
Bombs Over Brooklyn - Big Data - 1.0 - 
Clean - Big Data feat. Jamie Lidell - 2.0 - 
Dangerous - Big Data feat. Joywave - 1.0 - 
Bimpé - Aṣa - Beautiful Imperfection - 
Bingo - André van Duin - De Amstel Boyz Presenteren - 
スターゲイザー (DJ Sharpmarker Remix) - DJ Noriken feat. YUC'e (ゆーしえ) - スターゲイザー feat.YUC'e -『ストラとスフィア』OPテーマ- - 
Boom - BL3R - 
Dawn of a Dark Day - Black Sun Empire feat. Foreign Beggars - From the Shadows - 
SO HOT (THEBLACKLABEL remix) - BLACKPINK - SO HOT (THEBLACKLABEL remix) - 
BLACK or WHITE? - BlackYooh vs. siromaru - KERBEROX - 
Hyperspark - BlackY - Hyperspark - 
Where Is Home (Burial remix) - Bloc Party - Ministry of Sound: The Sound of Dubstep - 
The Bad Touch - Bloodhound Gang - Absolute Music 23 - 
Knockin' on Heaven's Door - Bob Dylan - Music & Words 1998 to 1963 - 
BoJack's Theme - Patrick Carney feat. Ralph Carney - BoJack's Theme - 
Freestyler - Bomfunk MC's - Global Hits 2002 - 
Mandarine Girl - Booka Shade - Mandarine EP - 
Born to be - nano (ナノ) - Born to be - 
Break Ya Self (Wipeout mix) - B Phreak & Groove Allegiance - Wipeout Pulse - 
Play with it (Gigi B Mix) - Breakdown feat. Whiskey Pete Julz - 
Breakfast in America - Supertramp - Millennium Gold - 
"Toxic" The Video - Britney Spears - In the Zone - 
Unclesam Goddamn - Brother Ali - Vice CD, Volume 14: Number 4 - 
Reality - Bro Safari feat. Sarah Hudson - 
Do Re Mi - Budi - 
Tuesday (Radio Edit) - Burak Yeter feat. Danelle Sandoval - Tuesday - 
Butterfly (Aki Remix) - Smile - Smile - 
Butterfly (Upswing mix) - SMiLE.dk - Smile Paradise - 
Atrévete, Te, Te - Calle 13 - Superventas 2007 - 
Summer - Calvin Harris - We Love Summer 2014 - 
I Need Your Love - Calvin Harris feat. Ellie Goulding - Joey Essex Presents Essex Anthems - 
Dance on the Mars - Camellia (かめりあ) - dreamless wanderer - 
dreamless wanderer - Camellia (かめりあ) - dreamless wanderer - 
δ:for the DELTA - Camellia (かめりあ) - PLANET//SHAPER - 
Coliseum - Campo - 
Can You Feel the Love Tonight - Elton John - Love Songs - 
Mighty & High - Can't Stop Won't Stop - 
Up and Away - Can't Stop Won't Stop feat. June - Up and Away - 
Hello (The Hair Kid Remix) - Capsule - 
Dream a Dream - Captain Jack - 
Late Night Kouhai (Sushi Killer Remix) - Capturelight - 
Shimakaze - Capturelight & Zenpaku - 
Human Leather Shoes for Crocodile Dandies - Caravan Palace - <|°_°|> - 
The Rhythm Of The Night - Cascada - 
Centuries vs Animals (Mashup) - Fall Out Boy and Maroon 5 - 
Centuries/Animals Mashup - Fall Out Boy and Maroon 5 - 
Opus One - Chamberlain x Kindred - 
The Writer - Chance The Rapper - 
Boom Clap - Charli XCX - The Voice Hits, Volume 1 - 
Amirah - Chasing Shadows - Ministry of Sound: The Sound of Dubstep - 
Love Is Over - chelmico - chelmico - 
Chemical - Move-Ya! & Steve Lavers - Wipeout Pulse - 
Cherry Pop - S3RL feat. Gl!tch - 
Opposite of Adults - Chiddy Bang - Bravo Black Hits, Volume 23 - 
Underwater - Voltz - We Are Magunoria Vol. 2 - 
China Dress - Memme - 
Chinese Restaurant - Memme - 
CHOCOLAT - TCY FORCE feat. Mariya Ise - Panty & Stocking with Garterbelt: The Original Soundtrack - 
Do I Wanna Know? (CHVRCHES Cover) - Arctic Monkeys - 
City Lights (Martin Buttrich remix, PSP cut) - Loco Dice - Wipeout Pulse - 
Rather Be - Clean Bandit feat. Jess Glynne - New Eyes - 
Close Your Eyes - Relect - Close your eyes - 
THE BADDEST FEMALE (나쁜 기집애) - CL - 나쁜 기집애 - 
Your Moment (Remastered Edit) - Code Black & Wasted Penguinz - 
Pandora - Code Black - Qlimax: Immortal Essence - 
Mosaic Kakera (モザイクカケラ) - SunSet Swish - モザイクカケラ - 
Spongebob - Coki - Ministry of Sound: The Sound of Dubstep 3 - 
Bendera (New Version) - Cokelat - Untukmu INDONESIA-ku - 
Over U - Cola Splash & Gersonik - 
Onyx - CoLD SToRAGE - Wipeout Pure - 
Paradise - Coldplay - Radio 538 Hitzone 60 - 
Cold - Jeff Williams feat. Casey Lee Williams - RWBY: Volume 3 Soundtrack - 
Chillin' It - Cole Swindwell - 
A Real Hero - College feat. Electric Youth - 
Uy Uy Uy - Compass feat. Carlos Ann and Kool A.D. - 
Trumpsta - Contiez feat. Treyy G - Absolute Music 73 - 
Fool's Paradise - Don McLean - Platinum - The Ultimate Collection - 
Rhythm of the Night - DeBarge - Smash Hits Party - 
Crimson Belvedere ~ Eastern Dream - Demetori - Like Facing the Abyss ~ Willow Hazes in Spring Rain - 
Bad Apple!! (Cristina Vee English Cover) - Alstroemeria Records - 
Boxer (original mix) - Crookers - From Then Until Now - 
Trapped (Hi-tack radio mix) - Peter Gelderblom vs. Dan Parker - Club Base 2008.1 - 
Crystal Sky - S3RL feat. Sara - 
I Walk Alone (Commercial Club Crew Remix Edit) - Crystal Lake vs Commercial Club Crew - 
I Walk Alone (Radio Edit) - Crystal Lake vs Commercial Club Crew - 
Next Planet - Cubicolor - 
cyberbird - Gabriela Robin - Ghost in the Shell STAND ALONE COMPLEX CD-BOX - 
Daddy DJ - Daddy DJ - Global Hits 2002 - 
Gasolina - Daddy Yankee - 
Around the World - Daft Punk - Best of 538 Dance Smash Summer Edition - 
Derezzed - Daft Punk - TRON: Legacy - 
Digital Love - Daft Punk - Got Dance? - 
Get Lucky (radio edit) - Daft Punk feat. Pharrell Williams - Get Lucky - 
Harder, Better, Faster, Stronger - Daft Punk - Musique, Volume 1: 1993-2005 - 
Instant Crush - Daft Punk feat. Julian Casablancas - 
Lose Yourself to Dance - Daft Punk - 
Television Rules the Nation / Crescendolls - Daft Punk - Alive 2007 / Alive 1997 - 
Around the World / Harder Better Faster Stronger - Daft Punk - Alive 2007 / Alive 1997 - 
Never Rains (M&Ace Remix) - Dance R Us - 
Never Rains (Radio Edit) - Dance R Us - 
Never Rains (X-Cess! Remix) - Dance R Us - 
Gubben i lådan - Daniel Adams-Ray - 
打上花火 - DAOKO x 米津玄師 - 打上花火 - 
BLISS - dark cat and jHacs - 
Sandstorm - Darude - The Biggest Breakdowns of All Time - 
Don't Sing (feat. Benny Sings) - DatA feat. Benny Sings - Don't Sing - 
デート・ア・ライブ - sweet ARMS - 劇場版デート・ア・ライブ 万由里ジャッジメント ORIGINAL SOUNDTRACK - 
Deja Vu - Dave Rodgers - Super Eurobeat Presents Initial D Super Euro Best - 
Night Fever - Dave Rodgers & Mega NRG Man - SUPER EUROBEAT presents INITIAL D 〜D SELECTION 2〜 - 
Love is Gone - David Guetta and Chris Willis - Pop Life - 
Baby When the Light - David Guetta feat. Cozi - Pop Life - 
Titanium - David Guetta(feat) Rob Swire - 40 Years of Disruptions - 
Ascension - David Eman - 
Play Hard - David Guetta feat. Ne-Yo & Akon - Play Hard - 
Sexy Bitch - David Guetta feat. Akon - The Best Of - 
Day After Day - Millennium - Pioneer: The Album, Volume 7 - 
I'm Not Alone - D.Baola - 
Flying High - DC-10 (DCX) - 
Deadly Premonition (Whistle Theme) - 
I Remember (original mix) - Kaskade & deadmau5 - I Remember - 
Raise Your Weapon (Madeon remix) - deadmau5 - Raise Your Weapon (Remixes) - 
Raise Your Weapon - deadmau5 - 4×4=12 - 
The Veldt - deadmau5 feat. Chris James - The Veldt EP - 
Waters - Debris and Clarx - 
HIBANA (ヒバナ) - DECO*27 feat. Hatsune Miku (初音ミク) - HATSUNE MIKU 10th Anniversary Album 「Re:Start」 - 
Reversible Campaign (リバーシブル・キャンペーン) - DECO*27 - GHOST - 
Streaming Heart (ストリーミングハート) - DECO*27 feat. Hatsune Miku (初音ミク ) - EXIT TUNES PRESENTS Vocalofantasy - 
Heart a la mode - DECO*27 feat. Hatsune Miku and 初音ミク - 
Love Doll - DECO*27 feat. GUMI - 
HOME - DECO*27 x 40mP feat. Hatsune Miku - 
Deep Sea Girl - Hatsune Miku - 
Deep Sea Girl (深海少女) (Piano Ver.) (Lizz Robinett English Cover) - Hatsune Miku (初音ミク) - 
Bubbletop (DF's Bubble Wrapped Mix) - Dennis Ferrer feat. Sagine - 

The Boy Who Murdered Love - Diana Vickers - Songs From the Tainted Cherry Tree - 
Til Death (Technoposse Remix) - Til Death - Til Death - 
Til Death (Technoposse Remix Edit) - Til Death - Til Death - 
Make It Real - Dirty Stab - 
Disconnected - Helblinde - 
Tricky Disco - Discotronic - 
Divide - Jeff Williams feat. Casey Lee Williams - RWBY: Volume 3 Soundtrack - 
United State of Pop 2014 (Do What You Wanna Do) - DJ Earworm - United State of Pop 2014 (Do What You Wanna Do) - 
DMC WORLD CHAMPION 2013 - DJ FLY - 
Earthquake instrumental - DJ Fresh - 
Flashlight - DJ Fresh feat. Ellie Goulding - The Biggest Breakdowns of All Time - 
'Louder' - DJ Fresh feat. Sian Evans - 
Hot Right Now - DJ Fresh feat. Rita Ora - The Biggest Breakdowns of All Time - 
Dear You - DJ Genericname - 
All the things she said (Radio Mix) - DJ Gollum feat. Scarlet - 
Exceeder - Dj Mason - 
Break Away - DJ Noriken - #HYPRFLVX - 
Coming True - DJ Noriken - シンシサクラク・エンハンサー - 
Kaguratsuki - DJ Noriken - #HYPERFLVX - 
Daybreak - DJ Noriken - Driven' De:st-ructure 2  - 
Bluebird Story (feat. Jumelles) - DJ Okawari - Diorama - 
Represent - DJ Okawari feat. 金原千恵子 - Kaleidoscope - 
I Remember - Dj Passion - 
Anima Libera - DJ Raaban - 
Be Alive! - Nightcore - Dreamworld - 
Drop The Base - Dj Raaban - 
Addict - S3RL - 
Baby Baby - S3RL - 
Crank It Louder - S3RL - 
S.L.U.T Hardcore - S3RL - 
Take Me - S3RL - Make You Move / Take Me / You'll Never - 
Waves (Danny R. Radio Edit) - DJ Satomi - 
Moving Shadow - DJ Shimamura feat. Yukacco - MAX - 
Magik Night - DJ Shimamura feat. Yukacco - Alkanet - 
Like A Rainbow Feat. Yukacco - DJ Shimamura - Elektronix - 
Open Your Heart - DJ Shimamura x Mitomoro feat. Lindsey Marie  - ORTHODOX - 
Turn Down For What (MO BUTT PROPANE REMIX) - DJ Snake - 
Flying High (DJ Splash Remix) - DC-10 (DCX) -  - 
DJ Whore - S3RL feat. Tamika - 
Burning Me - DJ Noriken - #HYPRFLVX - 
Call to Me - DJ Noriken - SKETCH BOOK! Anthology 3 - 
Enjoy This Time - DJ Noriken feat. yukacco - #From_Ten_Wonderland - 
#Magicalgirl_Syndrome - DJ Noriken - HAPPYNATION #03 - 
Matilda - DJ Noriken - METAMORPHOSE - 
See The Lights - DJ Noriken - 明星デストピア - 
Summerlights - DJ Noriken - EDP presents ravemania speed - 
Taurus - DJ Noriken - 
Midnight Train - DJ OKAWARI feat. Emi Meyer - Compass - 
Bad Chick - DJ Shimamura - Lilium X3 - 
BIG BOOBS INSANITY (Buchiage Jungle Terror Mix) - DJ Shimamura - JP-H/D #6 - 
Raver's In The Sky (Exclusive Summer Remix) - DJ Shimamura - 
Starlight (Could You Be Mine) (Colin McLoughlin Remix) - Don Diablo & Matt Nash - Starlight (Could You Be Mine) (Remixes) - 
Starlight (Could You Be Mine) (extended) - Don Diablo & Matt Nash - Starlight (Could You Be Mine) (Remixes) - 
On My Mind - Don Diablo - 
Don't You Worry Child - Swedish House Mafia - I Love Verano 2013 - 
Danza Kuduro (DJ EBo Remix) - Don Omar feat. Lucenzo, Daddy Yankee, Akon, and Pitbull - 
Whatever Will Be, Will Be (Que Será, Será) - Doris Day - Eis am Stiel, Volume 8 - 
Madernach Fik Laaib (الدوزي - ما درناش فيك العيب) - Douzi - My Life - 
Nuthin But a 'G' Thang Uncut & Dirty - Dr. Dre feat. Snoop Dogg - 
The Wash - Dr. Dre & Snoop Dogg - "The Wash" Original Motion Picture Soundtrack - 
The Mission - Dread Pitt and Yung Fusion - 
Take You Back VIP - Vaizo feat. Pandub - 
Future Cαndy (iMeiden Remix) - YUC'e (ゆーしえ) - 
Moskau - Dschinghis Khan - 40 Jahre ZDF-Hitparade - 
Recalled to Life - Dutch Master - Hardstyle Attack 2010 - 
Recalled to Life - Dutch Master - Explosive Car Tuning 22 - 
Cool Kids - Echosmith - Acoustic Dreams - 
Cool Kids vs Kids - Echosmith vs MGMT - 
Annul - 0edit - Neotokyo GSDF - 
Stereo Love - Edward Maya feat. Vika Jigulina - Top Chart - 
Stereo Love - Edward Maya&Vika Jigulina - Best of 2010 - Die Zweite - 
Shape of You (J.Fla Cover) - Ed Sheeran - 
All Alone With You - EGOIST - All Alone With You - 
Blue (Da Ba Dee) - Eiffel 65 - Fired Up! - 
Move Your Body - Eiffel 65 - 
Sugar Rush (Centron Remix) - Virtual Riot - 
Wave - Eli Way - 
Lights (single version) - Ellie Goulding - Lights - 
Lights (Shook remix) - Ellie Goulding - Lights - 
Mr.Blue Sky - ELO - 
De guerre lasse - Elyose - Ispo Facto - 
Fractal - Elyria feat. Danyka Nadeau - 
Anima Libera (Sweet Edit) - Emi - 
Energetic Techno Core (Royalty Free Music - Audiojungle Preview) - Flutist - 
Masked bitcH (colate remix) - Giga-P (ギガP)×おればなな feat. GUMI - 
Honey Moon Un Deux Trois (蜜月アン・ドゥ・トロワ) (Lucy English Cover) - DATEKEN feat. Kagamine Rin (鏡音リン) - 
Call on me (HD) - Eric Prydz - 
Septette for the Dead Princess (亡き王女の為のセプテット) - ZUN - 東方紅魔郷 ~ Embodiment of Scarlet Devil. - 
Pjanoo (club mix) - Eric Prydz - Promo Only: Mainstream Club, October 2008 - 
Emerlad Red (2012) - Erick Upheaval - 
os-宇宙人 (Asterisk Makina Remix) - Asterisk - Asterisk Works 3 - 
American Boy - Estelle feat. Kanye West - Shine - 
日本式硬核-OukaRanman- - ETIA. - 
Discord - The Living Tombstone - Emotions of Note - 
Sweet Dreams (Are Made of This) - Eurythmics - Sweet Dreams (Are Made of This) - 
Everyday - Buddy Holly - Yesterdays Gold: 120 Golden Oldies, Volume 1 - 
쉐이크 (Shake)! - E.via - Must Have - 
Dance, Dance But It's Let's Get It Started by The Black Eyed Peas (William Maranci Mashup) - Fall Out Boy and The Black Eyed Peas - 
Thnks fr th Mmrs - Fall Out Boy - Alternative Times, Volume 81 - 
Don't Speak - Far East Movement feat. Tiffany (티파니) of 소녀시대, King Chain - IDENTITY - 
Like a G6 - Far East Movement feat. The Cataracs & Dev - Like a G6 - 
Freal Luv - Far East Movement, Marshmello feat. 찬열 of EXO, Tinashe - IDENTITY - 
Feel Good in Black and Yellow - Wiz Khalifa and Gorillaz feat. De La Soul - Black and Yellow - Single - 
Feel The Melody - S3RL feat. Sara - 
Horizons - Feint feat. Veela - 
Reprise - Feint - 
Pure Imagination - Fiona Apple - Pure Imagination - 
Lost in Thoughts All Alone (English Version) (AmaLee Cover) - AmaLee - 
Lost in Thoughts All Alone (English Version) - Rena Strober - 
Lost in Thoughts All Alone (if〜ひとり思う〜) - Renka (蓮花) - if〜ひとり思う〜 - 
Lost in the Waves (English Version) - Matthew Mercer and Rena Strober - 
End of All (Land) (すべての路の果てに~地) (English Version) - 森下弘生 - ファイアーエムブレム if ORIGINAL SOUNDTRACK - 
End of All (Sky) (すべての路の果てに~天) (English Version) - 森下弘生 - ファイアーエムブレム if ORIGINAL SOUNDTRACK - 
Lost in Thoughts All Alone (Shigure's Version) (English Version) - Matthew Mercer - 
Lost in Thoughts All Alone (Shigure's Version) - Yoshimasa Hosoya - 
ENISHI ~For Sakura and Elise~ - Hiroki Morishita (森下弘生) - ファイアーエムブレム if ORIGINAL SOUNDTRACK - 
She Is A Maniac - Flashdance - 
Flat Out - Dopamine - Wipeout Pulse - 
Little Lies - Fleetwood Mac - Tango in the Night - 
Crave You (Adventure Club Dubstep Remix) - Flight Facilities feat. Giselle - Crave You (Adventure Club Dubstep Remix) - 
Crave You - Flight Facilities feat. Giselle - Nova Tunes 2.3 - 
Right Round - Flo Rida feat. Ke$ha - Right Round - 
Whistle (Newklear Re-Boot Extended) - Flo Rida - 
Whistle - Flo Rida - Now That's What I Call Running 2014 - 
This Is How We Roll - Florida Georgia Line feat. Luke Bryan - 
DAYS - Flow - DAYS - 

Believe Me - Fort Minor - Now Autumn 2006 - 
Pumped Up Kicks (original version) - Foster the People - Pumped Up Kicks: Remixes - 
Don't Stop (TheFatRat remix) - Foster the People - Don't Stop Remix - 
Memory (radio mix) - Fragma - Dance Nation 2009 - 
Memory (Rob Mayth Remix) - Fragma - 
Evil Eye - Franz Ferdinand - Live EP - 
Love Illumination - Franz Ferdinand - Right Action / Love Illumination - 
No You Girls - Franz Ferdinand - So Fresh: The Hits of Winter 2009 - 
Take Me Out - Franz Ferdinand - Triple J: Hottest 100 of All Time - 
Just Freakin' - Freakadelika - Club Rotation, Volume 38 - 
From Shadows - Jeff Williams (feat. Casey Lee Williams) - RWBY: Volume 1 Soundtrack - 
Frontline - Ed Rush, Optical & Matrix - Wipeout Pulse - 
MTBD (멘붕) - CL - CRUSH - 
Blue Bird (ブルーバード) - ikimonogakari (いきものがかり) - ブルーバード - 
Overclock - Fusk Asker - 
Blush (Moe Shop Remix) - Fusq feat. MYLK - 
Perfume! x Superstar - Fusq and Moe Shop feat. Hentai Dude - Owarini Tokyo Liveshow - 
Kuusou Mesorogiwi (ENGLISH) - AmaLee and NateWantsToBattle - 
OUTRO. 신곡 (神曲) (Divina Commedia) - G-Dragon - 권지용 - 
奇跡の薔薇 - Galla - INITIAL D BEST SONG COLLECTION 1998-2004 - 
ambiguous - GARNiDELiA - Linkage Ring - 
Pure Imagination - Leslie Bricusse & Anthony Newley - Willy Wonka & the Chocolate Factory - 
Genre Police - S3Rl feat. Lexi - 
Estonia: Rockefeller Street - Getter Jaani - Eurovision Song Contest: Düsseldorf 2011 - 
Nightfall - Getty - Krazy Psycho Bass 2 - 
Bad Monkey - Getty - HARDCORE HONORS - 
(Feel Like) Jam - Getty - A/LOG:02 - 
Growler - Getty - J-NERATION 7 - 
Paradox - Getty - Five-Star Luster - 
Pacific Coast Highway - Ghasper - 
thrace - Gabriela Robin - Ghost in the Shell STAND ALONE COMPLEX CD-BOX - 
Bla Bla Bla - Gigi D'Agostino - Viva Hits 8 - 
Swagger - Gingy - Wipeout HD Fury - 
Dawn of Asia (ginkiha mix) - ginkiha - 
All Day Mashup Let It Out (New Remix Song) - Girl Talk - 
Like The Sand - G.I.T - 
GIVE UP - i am robot and proud feat. lasah - "I LOVE YOU," - 
furioso melodia - gmtn. (witch's slave) - 
Crazy - Gnarls Barkley - Black Summer Party: Best Of, Volume 5 - 
Going On - Gnarls Barkley - 2009 GRAMMY Nominees - 
Brynhildr in the Darkness -Ver. EJECTED - Nao Tokisawa - 
本当の言葉 - FOOT STAMP - Japan Is Punk as Fuck - 
Gold - Jeff Williams (feat. Casey Lee Williams) - RWBY: Volume 1 Soundtrack - 
gonna rice - Yoko Kanno - Ghost in the Shell STAND ALONE COMPLEX CD-BOX - 
DARE (video) - Gorillaz - DARE - 
Feel Good Inc - Gorillaz - Feel Good Inc - 
Stylo - Gorillaz - Plastic Beach - 
Somebody That I Used to Know - Gotye feat. Kimbra - More Music 2012 - 
One Night in Arabia - Go Go Girls - SUPER EUROBEAT presents INITIAL D 〜D SELECTION 3〜 - 
ARCADIA - Gram (DJ Genki) - The Requiem - 
Sigmund (The Requiems Extended MIX) - Gram (DJ Genki) - The Requiem - 
Yggdrasil - Gram (DJ Genki) vs Kobaryo - The Requiem - 
Hit That Jive - Gramatik - Street Bangerz Vol. 2 - 
Just Jammin' - Gramatik - Street Bangerz Vol. 2 - 
Weapon - Grant feat. Baum - Rocket League x Monstercat Vol. 1 - 
Emiya (エミヤ) (guitar version)  - CROW'SCLAW - 十七分割 - 
Boulevard of Broken Dreams - Green Day - American Idiot - 
Hit or Miss - greyl - RE PAK 4 - 
Touch me - greyl - RE PAK 4 - 
Anaconda / Grisaiaconda (Triple-Q Mashup Remix) - Nicki Minaj - 
I want (Я хочу) - GRIVINA - Я хочу - 
Invisible - GUMI & Rin - 
Masked bitcH - Giga-P (ギガP)×おればなな feat. GUMI - ぎがばなな ざ べすと 〜USUSHIO味〜 - 
Masked bitcH (Satsuki ga Tenkomori/Club Remix) - Giga-P (ギガP)×おればなな feat. GUMI - 
Paradise City - Guns N' Roses - 1992-12-05: Night of the Livid Red Head: Estadio River Plate, Buenos Aires, Argentina - 
Infinity 2008 (Klaas remix) - Guru Josh Project - Ministry of Sound: Addicted to Bass 2009 - 
Stereo Hearts - Gym Class Heroes feat. Adam Levine - 
Sand Planet (砂の惑星) - Hachi feat. Hatsune Miku (初音ミク) - 
What Is Love - Haddaway - The Best of Dance Non Stop Mix - 
Tip Taps Tip - HALCALI - Tip Taps Tip - 
Out of Touch - Hall & Oates - Veronica Top 1000 Allertijden: Editie 2008 - 
源流懐古 - Halozy - Halozy Best Vol.1 - 
Poltergeist (Nightcore) - Zatox feat. Nikkita - 
Alien Alien (エイリアンエイリアン) (Nhato Remix) - NayutalieN (ナユタン星人) - EXIT TUNES PRESENTS Entrance Dream Music3 - 
Arcadia (radio edit) - Hardwell & Joey Dale feat. Luciana - Fun Dancefloor Winter 2015 - 
Spaceman - Hardwell - Spaceman - 
DAS GEHT BOOM (SHAG RAGGA!) - Harris & Ford vs. Gordon & Doyle feat. Lisah - 
Harumodoki / 春擬き(Asterisk DnB Remix) - Nagi Yanagi - 
Harumodoki - Nagi Yanagi - 
シンフォニック・ラブ - 橋本みゆき - ましろ色シンフォニー -Love is pure white- Sound Track - 
Chameleon Love (カメレオン・ラブ) - Hatsune Miku - 
Hatsune Miku - Personality Complex (ペルソナリティ・コンプレックス) - Hatsune Miku - 
Rubik's Cube - Hatsune Miku - 
Love Philosophia (恋愛フィロソフィア) - Kurousa-P (黒うさP) feat. Hatsune Miku (初音ミク) - 5th ANNIVERSARY BEST - 
Rolling Girl - Hatsune Miku (初音ミク) - 
This Fucked-Up Wonderful World Exists For Me (このふざけた素晴らしき世界は、僕の為にある) - n.k feat. Hatsune Miku (初音ミク) - 
Addicted (Revised Version) - Circus-P - FIVE - 
Earthquake (Fytch Remix) - Little Boots - 
World is Mine (AshZone Remix) - Hatsune Miku - 
Never Rains ✮ (Nightcore) - Dance R Us - 
寄明月 - SING女團 - 
Wanna - KARA (카라) - Revolution - 
Fabulous Secret Powers!! - He-Man - 
maldades - Hector El Father - 
Grief & Malice - Helblinde - 
Imagine Breaker - Helblinde - 
Love is War - Helblinde - 
Ritsuen!! (トランペットブラック者) - Helblinde - Untitled Album - 
Are You Ready For The Fluor - Helmuth - 
Here Comes the Hotstepper (Evian version) (Yuksek remix) - Baby & Me - Fun Radio: Dancefloor Anthology - 
X / Love - Hex Cougar x Zack Gray - 
HIBIKASE (ヒビカセ) - Reol (れをる) - 
Aston Martin - Higher Brothers feat. Ken Rebel - Black Cab - 
WeChat - Higher Brothers feat. Keith Ape - Black Cab - 
Work It Out - Higher Self & Tom Budin feat. SWEEDiSH - 
Made in China - Higher Brothers feat. Famous Dex - Black Cab - 
Fake - HIGHSOCIETY feat. Amy Kirkpatrick - 
Bring Me Back - High N' Rich - 
『かなしみアップデイト』  - HINTO - 
『シーズナル』  - HINTO - 
promise - 広瀬香美 - タイアップコレクション〜広瀬香美のテレビで聴いたあの曲達〜 - 
Lost in Thoughts All Alone  (if〜ひとり思う〜) (Blue Forest Version) - Renka (蓮花) - if〜ひとり思う〜 - 
Irony (アイロニ) - majiko (まじ娘) - Contrast - 
Home - Jeff Williams feat. Casey Lee Williams - RWBY: Volume 4 Soundtrack - 
Shonen Heart - Home Made Kazoku - 
masterpiece - Hommarju feat. Latte - EXIT TRANCE PRESENTS SPEED アニメトランス BEST 7 - 
Hands Up - Hommarju - WAVES - 
Flashes (Extended) - Dollscythe - beatmania IIDX 22 PENDUAL ORIGINAL SOUNDTRACK VOL.2 - 
Honey Moon Un Deux Trois (蜜月アン・ドゥ・トロワ) - DATEKEN feat. Kagamine Rin (鏡音リン) - 
Natsuzora - ナツゾラ - HoneyComeBear - 
Follow Me Blind (Radio Edit) [Full Version] - Honka - 
Follow Me Blind - Honka - 
Dust - M|O|O|N - Hotline Miami 2: Wrong Number - 
Miami - Jasper Byrne - Hotline Miami EP - 
Hotline Spikes (Death Grips X Hotline Miami Mashup) (Sewerslvt Mashup) - Jasper Byrne and Death Grips - 
How I Want Ya - J-Man feat. Lara Wilson - 
Quake Howling - hurce - Krazy Psycho Bass 2 - 
Plastiktüte - Husky - Riverside POP Free - 
Somebody Else - hvdson - 
City Lights - HyperJuice feat. EVO+, Jinmenusagi - 
City Lights (Pa's Lam System Remix) - HyperJuice feat. EVO+, Jinmenusagi - 
City Lights (Tomggg "Sunday Candy" Remix) - HyperJuice feat. EVO+, Jinmenusagi - 
City Lights (Zekk Remix) - HyperJuice feat. EVO+, Jinmenusagi - 
GIRL - HyperJuice feat. Jinmenusagi - 
I&U - 安田レイ - パスコード4854 - 
I Ship It - Icona Pop - 
Konoha's State of The World - Hatsune Miku & IA - Blindfold City Days - 
It Was a Good Day - Ice Cube - R&B SummerJamz - 
Make a Move - Icon for Hire - Christian Rock Hits X 2012 - 
Peanut Choker - Iglooghost - Little Grids - 
Mastication numérique - Igorrr - Poisson soluble - 
Spheres - ilan Bluestone - 
Fractures - Illenium feat. Nevve - Fractures Ft. Nevve - 
Flying (Anarky Remix) - ill.Gates and Stephan Jacobs feat. Jackie Rain - 
Radioactive - Imagine Dragons - iTunes Session - 
Clouds - Imagined Herbal Flows - 
I'm the One - Jeff Williams feat. Casey Lee Williams - RWBY: Volume 3 Soundtrack - 
Won't You Stay - Indivision & Livewire feat. Tasha Baxter - 
I Won't Fall Apart - Jager - Super Eurobeat, Volume 204 - 
Night & Day - Mr. Groove - SUPER EUROBEAT presents INITIAL D 〜D SELECTION 3〜 - 
Burning up for You (Extended Mix) - Sara - Eurobeat Masters, Volume 2 - 
Love & Money (extended mix) - Za-Za - Eurobeat Masters, Volume 1 - 
Wings of Fire - Mako & Sayuki - SUPER EUROBEAT presents INITIAL D 〜D SELECTION 2〜 - 
Dance Around the World - Delta Queens - SUPER EUROBEAT PRESENTS INITIAL D D SELECTION - 
Don't Stand So Close - Dr. Love - SUPER EUROBEAT presents INITIAL D 〜D SELECTION 2〜 - 
If I Didn't Care - Ink Spots - 
inner universe - ORIGA - Ghost in the Shell STAND ALONE COMPLEX CD-BOX - 
Cluster A (Fusq Remix) - in the blue shirt - 
Border of extacy - IOSYS - 東方真華神祭 - 
Run to the Hills (video) - Iron Maiden - The Number of the Beast - 
Kau Adalah - Isyana Sarasvati feat. Rayi Putra - Explore! - 
Sekali Lagi (from "Critical Eleven") - Isyana Sarasvati - Paradox - 
Nonstop Pop 2014 Mashup - Isosine - 
My Life Is a Party (radio edit) - ItaloBrothers - The Dome, Volume 63 - 
Evacuate the Dancefloor - Cascada - Miss Independent: From the Ladies of Pop - 
It's My Turn - Jeff Williams feat. Casey Lee Williams - RWBY: Volume 3 Soundtrack - 
Nonstop Pop 2015 Mashup  New and beautiful - Isosine - 
In My Mind (Axwell radio edit) - Ivan Gough, Axwell, Feenixpawl & Georgi Kay - Absolute Workout - 
Cloud 9 - Itro & Tobu - 
Wild Growth - IVV - POPOVER+TEATIME 3 - 
i do - Ilaria Graziano - Ghost in the Shell STAND ALONE COMPLEX CD-BOX - 
FIRE - J Spiff - 
Candy Princess - Freezer feat.妃苺 - J-NERATION 6 - 
How I Want Ya - J-Man feat. Lara Wilson - 
Take Ü There (Baile Funk Remix) - Jack Ü feat. Kiesza - 
Take Ü There - Jack Ü feat. Kiesza - Skrillex and Diplo Present Jack Ü - 
Ghost Town - Josh A & iAmJakeHill - Chaos - 
Endless Nightmare - Jake Hill and Josh A - 
Stay - Jakoban and D!avolo feat. Gaby Henshaw - 
Peeping Tom - Jamie Berry feat. Rosie Harte - Peeping Tom - 
Talk Dirty - Jason Derulo feat. 2 Chainz - The Dome, Volume 68 - 
Whatcha Say - Jason Derülo - Radio 538 Hitzone 53 - 
Hood Gone Love It - Jay Rock feat. Kendrick Lamar - Follow Me Home - 
Dirt Off Your Shoulder (Smle Jupe Remix) - Jay Z - 
Honey Moon Un Deux Trois (蜜月アン・ドゥ・トロワ) (じろ Cover) - DATEKEN feat. Kagamine Rin (鏡音リン) - 
Escape - USAO - Kick's For Liberation 2 - 
Bambino - Jean Dujardin - Hits & Dance: Summer 2006 - 
Shining In The Dark - JEDDI feat. Chuck New - 
Wanderlust - Jelle Slump feat. Aidan O'Brien - 
It's Amazing - Jem - 
Silent Moon - Jia Peng Fang (賈鵬芳) - Pacific Moon - 
Voodoo Child ( Slight Return ) - Jimi Hendrix - 
Love is a Miracle - Jinco feat. SVNAH - Love is a Miracle - 
JINGO JUNGLE -HBB Remix- - MYTH & ROID - eYe's - 
Maximum Overload - Jinpachi Futushimo - 
Make A Move On Me - Joey Negro - 
il vento d'oro  (Golden Wind) - Yugo Kanno - JOJO's Bizarre Adventure Golden Wind O.S.T vol.1 Overture - 
Dere Dere - Josip On Deck - 
さよならは笑顔で (fu mou Remix) - Joy Time People - 
D.A.N.C.E. (MSTRKRFT remix) - Justice - D.A.N.C.E. (Remixes Extended) - 
D.A.N.C.E. (live at Inrocks Festival) - Justice - ✝ - 
DVNO (radio edit) - Justice - DVNO - 
Phantom Pt. II (Soulwax Remix) - Justice - 
Phantom, Part II (Boys Noize remix) - Justice - Phantom, Part II - 
Just Girly Things Remix - Dawin feat. Kalin and Myles - 
feel good - jåmvvis - celebration  - 
Electrode - K-391 - K-391 Tracks of 2012 - 
Tsubasa wo Kudasai (翼をください) - 桜高軽音部 - ふわふわ時間 - 
ギガンティックO.T.N - ギガP×おればなな feat. 鏡音レン - ぎがばなな ざ べすと 〜USUSHIO味〜 - 
The Lost One's Weeping (ロストワンの号哭) - Neru feat. Kagamine Rin (鏡音リン) - 世界征服 - 
Suki Kirai (スキキライ) - HoneyWorks feat. Kagamine Rin (鏡音リン), Kagamine Len (鏡音レン) - マジカルミライ 2014 OFFICIAL ALBUM - 
</emotional> - kamome sano - Lilium X2 - 
Cold Inflation (Extend Mix) - kanone vs. Yooh - Energy Of The Moon - 
Can't Tell Me Nothing - Kanye West - Now That's What I Call Music! 26 - 
Flashing Lights - Kanye West feat. Dwele - 
Wolves - Kanye West feat. Vic Mensa & Sia - The Life of Pablo - 
Good Life - Kanye West feat. T-Pain - Graduation - 
Tidal - Karaplex and Finder - 
STEP - KARA (카라) - BEST GIRLS - 
Cycle Hit (サイクルヒット) - KASAI HARCORES (葛西ハーコーズ) - 葛西ハーコーズ EP2 オールスターズ - 
Karinui - Noto Mamiko - 
1234567890 (Titancube Remix) - KATOMORI - 
One Day (Vandaag) - Bakermat - We Love Summer 2014 - 
Dark Horse - Katy Perry feat. Juicy J - We Love Summer 2014 - 
Chained to the Rhythm - Katy Perry feat. Skip Marley - Witness - 
Nightcall - Kavinsky - Electro Shock - 
Kawaii Fashion 2016 - Mikeneko Homeless (三毛猫ホームレス) feat. Onomatope Daijin (オノマトペ大臣) - 
TiK ToK - Ke$ha - Animal - 
Take It Off - Ke$ha - Animal - 
Paralyzed (Mystery Skulls cover) - Ken Ashcorp - 
Absolute Territory (Remix) - Ken Ashcorp - 
Die Young - Ke$ha - Fun Radio: Summer Dance 2013 - 
Danger Zone - Kenny Loggins - Best of the 80s - 
Let Me Show You - Kero One & Azure - Kero & Azure - 
R.I.P. - Kero One feat. Suhn - Color Theory - 
Pursuit of Happiness (Nightmare) - Kid Cudi feat. MGMT & Ratatat - Man on the Moon: The End of Day - 
Day 'n' Nite - Kid Cudi vs. Crookers - Ministry of Sound: One R&B - 
Before My Body is Dry - Mika Kobayashi - 
Gomen ne, Iiko ja Irarenai. (ごめんね、いいコじゃいられない。) - Sawai Miku - 
Blumenkranz - 澤野弘之 - KILL la KILL ORIGINAL SOUND TRACK - 
I want to know [lyrics] - Benjamin Anderson - 
Till I Die - CASG - 
鬼龍G@キLL - 澤野弘之 - BEST OF SOUNDTRACK【emU】 - 
The Beautiful World - 前田愛 - The Beautiful World - 
All the Way - Mikuni Shimokawa (下川みくに) - all the way - 
Get Down (Srav3R Remix) - Getty - Kirara Trails - 
Rainbow Tylenol - Kitsune2 - Squaredance - 
Rock My Emotions - Kitsune2 - Squaredance - 
Robot Love - Klaypex ft. GRÉTA - 
Make It High - KO3 & Relect - Bright Colors 4 - 
Let's Get Fxxked - KO3 vs Getty - 幻奏ドリームランド - 
Mosaic - KOAN Sound x Culprate x Asa x Sorrow - 
Speed Complexxx - Kobaryo feat. Srezcat - MIXPEED ACTION - 
lit (var) - Kensuke Ushio (牛尾憲輔) - A Silent Voice (Koe no Katachi) Original Soundtrack (映画 聲の形 オリジナル・サウンドトラック) a shape of light - 
The Rolling - kors k vs Camellia - S2TB Files7: Battle Royale - 
Sora - 下村陽子 - KINGDOM HEARTS Original Soundtrack COMPLETE - 
Rain - Motohiro Hata (秦基博) - 言ノ葉 - 
lots of love - KOTONOHOUSE feat.kotono - POPOVER+TEATIME 3 - 
pray - KOTONOHOUSE feat. Such - Such - innocent - 
Mukei Spirit (DJ AMAYA vs DJ USYN REMIX) - Kou Shibasaki (柴咲コウ) - 
Burn for You (The Cop 4 club mix) - Kreo' - Burn for You - 
Burn for You - Kreo' - Burn for You - 
New World - Krewella & Yellow Claw feat. Taylor Bennett - New World, Part 2 - 
Alibi - Krewella - Alibi - 
Calm Down - Krewella - New World, Part 1 - 
Calm Down (Chime and Halcyon Remix) - Krewella - 
New World - Krewella & Yellow Claw feat. Vava - 
Firestone - Kygo - Clubland 28 - 
Can't Get You Out of My Head - Kylie Minogue - Party: The Collection - 
Timeless - K A R M A - 
Earthquake - Labrinth feat. Tinie Tempah - Ministry of Sound: One R&B - 
Just Dance - Lady Gaga feat. Colby O'Donis - The Fame - 
Pokerface (live at the Cherrytree House piano & voice version) - Lady Gaga - Disco Heaven: The Fame B=2.0 - 
Telephone - Lady Gaga feat. Beyoncé - The Fame Monster - 
I Won't Work (やだ働かない)  - Lamaze-P feat. Hatsune Miku - 
君が泣くなら - Lamp - 
Summertime Sadness (Cedric Gervais remix) - Lana Del Rey - Future Trance, Volume 64 - 
Summertime Sadness (Reich & Bleich Remix) - Lana Del Rey - 
PsyStyle Nation - lapix & Massive New Krew - PsyStyle Nation - 
Big Ride - Lary and His Flask - 
Repairers of the Deceptive World (Kagaribito) (カガリビト) (lasah Cover) (English Ver) - Hatsune Miku (初音ミク) - 
INNOCENCE - Yasunori Mitsuda (光田康典) feat. lasah - INNOCENCE - 
Stairway to Heaven - Led Zeppelin - Hiawatha Express - 
START - Leftymonster -  - 
Blue Shift - Lemaitre - Relativity 1 - 
Excuse Me - Lemaitre - The Kitsuné Special Edition #2 (Kitsuné Maison 12 + Gildas Kitsuné Club Night Mix #2) - 
Wait (Elephante remix) - Lemaitre feat. LOLO - Singularity (remixed) - 
Wait - Lemaitre feat. LOLO - Singularity - 
All Eyes On Us - Lenno and Jack Novak feat. Racella - 
Remember Me (Extended Mix) - Leslie Parrish - Super Eurobeat, Volume 99 - 
Let's Just Live - Jeff Williams feat. Casey Lee Williams - RWBY: Volume 4 Soundtrack - 
lifecouldbeadream - Future James - 
Slow Down (WRLD Remix) - LIGHTS - 
Like Morning Follows Night - Jeff Williams feat. Casey Lee Williams and Lamar Hall - RWBY: Volume 4 Soundtrack - 
Thrifty (mashup) - Lil Dicky and Macklemore  - 
$ave Dat Money - Lil Dicky feat. Fetty Wap and Rich Homie Quan - 
Prayer in C (Robin Schulz remix) - Lilly Wood & The Prick - Fun Radio: Dancefloor Anthology - 
Get Low - Lil Jon & The East Side Boyz feat. Ying Yang Twins - Promo Only: Mainstream Radio, August 2003 - 
Prayer in C (Robin Schulz remix) - Lilly Wood & The Prick and Robin Schulz - Prayer in C - 
Work Harder - Widdly 2 Diddly - LISA Soundtrack - 
666 Kill Chop Deluxe - Widdly 2 Diddly - Lisa The Joyful Soundtrack  - 
Ex-Boyfriend - Lil Dicky - So Hard - 
Still Alive (Mirrors Edge OST) - Lisa Miskovsky - 
Crack traxxxx - Lite Show Magic - 
Crack Traxxxx (Exxxxtend Mixxxx) - Lite Show Magic - We are "Lite Show Magic" - 
Stronghold - Lite Show Magic - Raise Blaze in Fiction - 
Little Apple - Chopsticks Brothers - 
Every Little Earthquake - Little Boots - 
Redial - livetune feat. 初音ミク - 
living inside the shell - Steve Conte - Ghost in the Shell STAND ALONE COMPLEX CD-BOX - 
Vapor (Dustkey Remix) - Lockyn - 
Lollipop - The Chordettes - Yesterdays Gold: 120 Golden Oldies, Volume 1 - 
JOY - Lon (ろん) - 
Vamos a la playa - Loona - Ballermann Hits 2010 - 
Lost In Thoughts All Alone (English Version) (Adriana Figueroa Cover) - Adriana Figueroa - 
Lost In Thoughts All Alone (English Version) (Lizz Robinett Version) - Lizz Robinett feat. Dysergy - 
Love is in Danger (Extended Mix) - Priscilla - Eurobeat Masters, Volume 2 - 
Danza kuduro - Lucenzo feat. Don Omar - Emigrante del mundo - 
How Low - Ludacris - Battle of the Sexes (iTunes CountDown) - 
Despacito - Luis Fonsi feat. Daddy Yankee - Despacito - 
Dancing Wildly (狂喜乱舞) - Megurine Luka, Hatsune Miku, and GUMI - 
Watermelon - lulu + Mikeneko Homeless - This Christmas Lovely Day - 
Asagao - lulu + Mikeneko Homeless - 
LUVORATORRRRRY! - Reol (れをる) feat.nqrse - 
One Look - LVTHER feat. Mammals - Monstercat - Best of 2014 - 
'Hydrogen' [Hotline Miami Soundtrack] - M.O.O.N. - 
'Paris' [Hotline Miami Soundtrack] - M.O.O.N. - 
The Queen - M2U - Owarini Tokyo Liveshow  - 
Magnolia (VIP) - M2U feat. Guriri (グリリ) - Magnolia - 
Weapon (Live Launchpad Mashup) - M4SONIC - 
Do It 4 U - Machinedrum feat. D∆WN - Human Energy - 
Can't Hold Us - Macklemore & Ryan Lewis feat. Ray Dalton - 538 Hitzone: Best of 2013 - 
Thrift Shop - Macklemore & Ryan Lewis feat. Wanz - Thrift Shop - 
Mad World - Gary Jules - KFOG: Live From The Archives 11 - 
Finale - Madeon feat. Nicholas Petricca - Adventure - 
Pay No Mind - Madeon feat. Passion Pit - Adventure - 
Pop Culture - Madeon - Pop Culture - 
Hung Up - Madonna - Celebration: The Video Collection - 
Ghost Assasin (Hourglass Bonusmix) - Maduk feat. Veela - 
Rude - MAGIC! - The Voice Hits, Volume 1 - 
MAGICAL✰GIRL - Sushi Killer - 
Lean on - Major Lazer feat. MØ & DJ Snake - Absolute Summer Hits 2015 - 
Mendekat, Melihat, Mendengar - Maliq & Dessential - 
Wild Fire - MandoPony and Silva Hound - 
Just Another Night (Anthem 4) - Manian & Floorfilla - Energy NRJ: Hit Music Only! Best of 2013, Volume 2 - 
Gas Gas Gas - Manuel - Super Eurobeat Presents Initial D Fifth Stage D Selection - 
Digital Love - Mardial feat. Ramengvrl - Mardial & Friends - 
Mind Brand (マインドブランド) - Maretu feat. Hatsune Miku (初音ミク) - コインロッカーベイビー - 
Animals vs Centuries - Maroon 5 x Fall Out Boy - 
Sexual Healing (Kygo Remix) - Marvin Gaye - 
You Reposted in the Wrong Neighborhood Extended - ＳＨＯＫＫ青 - 
Medusa (Медуза) - MATRANG - ЭЙА - 
The Sound - Mayhem - Eggs and Other Songs - 
Mr. Almost (差不多先生) - MC HotDog (熱狗) - Mr. Almost - 
Shinespark (Evan King Orchestral Remix) - MDK - 
GIRL - Daoko - 
ME!ME!ME! - TeddyLoid feat. daoko - 
Meet Her At The Love Parade - Superstar DJs - 
Monster (DotEXE Dubstep Remix) - Meg & Dia - Mein Leben - 
Monster - Meg & Dia - Vans Warped Tour: 2007 Tour Compilation - 
Leave The Lights On (Krot Remix) - Meiko - 
Leave The Lights On - Meiko - 
Leave The Lights On (Stoto Remix) - Meiko - 
One - Metallica - The Videos: 1989-2004 - 
The Weekend - Michael Gray - Ultimate FloorFillers 2000-2010 - 
Moonlight Shadow - Mike Oldfield - Media Markt Collection: The 80s, Volume 2 - 
Purity - Mikeneko Homeless (三毛猫ホームレス) feat. Nagi Nemoto (根本凪) - 
Walk It Talk It - Migos feat. Drake - Culture II - 
City Down Under (M83 vs Men At Work mashup) - Mighty Mike - 
Soba ga Tabetai (そばが食べたい) (MMQX Remix) - Mikeneko Homeless - 
Kawaii Fashion - Mikeneko Homeless (三毛猫ホームレス) feat. Onomatope Daijin (オノマトペ大臣) - インターネット e.p. - 
America - Mikeneko Homeless (三毛猫ホームレス) x Masayoshi Iimori feat. Nagi Nemoto (根本凪) - 
Miku - Anamanaguchi feat. Hatsune Miku - Miku - 
Mastodon (Louis The Child Remix) - Milk N Cookies ft. Alina Renae - 
Stolen Dance - Milky Chance - The Dome, Volume 68 - 
lights by my side - DJ Noriken - Visio Nocturna - 
Mind-Blowing SIX Song Country Mashup! - 
Mirror Mirror (White Trailer) - Jeff Williams (feat. Casey Lee Williams) - RWBY: Volume 1 Soundtrack - 
Mirror Mirror Part II - Jeff Williams feat. Casey Lee Williams - RWBY: Volume 3 Soundtrack - 
Only You - Misael Gauna & Evence - 
Misery In A Bottle (Beaver's MashUps Mashup) - Christina Aguilera and Paramore - 
Misleading Title - S3RL feat. DEFI BRILATOR - 
ビバハピ - Mitchie M feat. 初音ミク - グレイテスト・アイドル - 
Arcadia Bae - Mitomoro - FÜGENE - 
Apropos - Mittsies - Helltaker Soundtrack - 
Epitomize (Sinner's VIP) - Mittsies - Epitomize (Sinner's VIP) - 
Epitomize (VIP Edit) - Mittsies - Epitomize (VIP Edit) - 
Epitomize - Mittsies - Helltaker Soundtrack - 
Luminescent - Mittsies - Helltaker Soundtrack - 
Vitality (VIP edit) - Mittsies - Helltaker Soundtrack - 
Vitality - Mittsies - Helltaker Soundtrack - 
Dameyo (ダメよ♡) - Mizca - ダメよ♡ - 
Here for You - Kygo feat. Ella Henderson - Now That's What I Call Music! 92 - 
Lady (Hear Me Tonight) - Modjo - Ministry of Sound: Chilled House Classics - 
Moestep - Moe Shop - 
Want You - Moe Shop - Want You - 
Superstar - Moe Shop feat. Hentai Dude - Moshi Moshi - 
Pastel - Moe Shop and Snail's House  - 
Optinuum (original mix) - Moguai - Optinuum (original mix) - 
Good Place - Mondgomery - 
Alive - Mondotek - 
All Is Hell That Ends Well - Two Steps From Hell - SkyWorld - 
The Prophecy - Tony Anderson feat. Aubrey Prunty - Movements of the Heart - 
Daughter of The Flame / Epic Hybrid Trailer - Audiopizza - 
God Mode - Sons of Amon - 
Too Young to Fall in Love - Mötley Crüe - Shout at the Devil - 
Bust the Future Wall (remixed by DJ VISAGE) - m.o.v.e - INITIAL D BEST SONG COLLECTION 1998-2004 - 
around the world - m.o.v.e - electrock - 
BREAK IN2 THE NITE - m.o.v.e - INITIAL D BEST SONG COLLECTION 1998-2004 - 
over drive - m.o.v.e - INITIAL D BEST SONG COLLECTION 1998-2004 - 
Rage your dream - m.o.v.e - electrock - 
ROCK IT DOWN (Radio edit) - m.o.v.e - REWIND 〜singles collection+〜 - 

Coco Jambo - Mr. President - All Stars Disco 9 & 10 - 
Motownphilly (remix radio edit) - Boyz II Men & Michael Bivins - Cooleyhighharmony - 
Heartbreaker (feat. John Legend) - MSTRKRFT - Heartbreaker - 
Sierra Leone - Mt Eden - Dubstep/DnB Collection - 
MTC - S3RL - Super Fun Happy Time - 
MTC2 - S3RL feat. SONiKA - 
無形スピリット - 柴咲コウ - CIRCLE CYCLE - 
Pyrotechniqué - Mullaha - 
Ring (su na Remix) - mus.hiba X su na - 
Pass the Dutchie - Musical Youth - The Best of the Eighties: Forty Tracks, Original Hits - 
[A]ddiction - EVO+ feat. Reol (れをる) x GigaP (ギガP) - EVOLUTION - 
Beautiful Girl - MVZR - 
I NEED U - BTS(방탄소년단) - 화양연화 pt.1 - 
Into My Arms - Mylo - 
Zenophile - Mylo - Trax #02 - 
Paralyzed - Mystery Skulls - 
Hellbent - Mystery Skulls feat. SnowBlood - Forever - 
Mythologia's End - Hatsune Miku - 
Frozen Rain - MYTH & ROID - JINGO JUNGLE - 
雪を聴く夜 - MYTH & ROID - eYe's - 
Tough & Alone - MYTH & ROID - eYe's - 
-to the future days - MYTH & ROID - eYe's - 
My Hardcore - RoughSketch Feat. DD"ナカタ"Metal - The Far East Hard Session - 
TRY UNITE! (aran Remix) - Nakajima Megumi - 
Tsukihana - Nana Kitade - 
Meikaruza (instrumental) - Nanahoshi Kangengakudan - 
夏祭り - 鬱P、ミナツキトーカ feat. 初音ミク - どう考えても私は悪くない - 
Hegira - necchi feat. Such - Such - innocent - 
Heartbeat - Nathalie - SUPER EUROBEAT PRESENTS INITIAL D D SELECTION - 
Riders on the Storm (Fredwreck feat. Snoop Dogg remix) - The Doors - The Doors Remixed - 
Neko Nation Anthem (S3RL remix) - Noc.V - 
Nasty - S3RL & 5H4RK80Y ft Thylie - 
A Cruel Angel Thesis (Director's Edit Version) - Yoko Takahashi - Neon Genesis Evangelion Soundtrack 1 - 
Neon - Jeff Williams feat. Casey Lee Williams - RWBY: Volume 3 Soundtrack - 
Free WiFi - NeoTune and TobiMorrow - 
NEVER RAINS (Lowcash Remix) - Dance R Us - 
Hold Me Back - Nicko Mills and Max Fail - 
Toulouse (Wumbaloo Remix) - Nicky Romero - 
Call From Babylon - Nick Skitz and Technoposse - Future Trance 69 - 
Disco Lazy Time - Nidji - 
ナイト・オブ・ナイツ - COOL&CREATE - 東方インストライク - 
Moonlight Shadow (Nightcore) - Mike Oldfield - 
My Life Is A Party (Nightcore) - ItaloBrothers - 
Anima Libera (Nightcore) - Dj Raaban - 
Ass up (Nightcore) - Baracuda - 
Blackout (Nightcore) - Breathe Carolina - 
Cocaine (Nightcore) - Nomy - 
Dam Dadi Doo - Nightcore - Caliente - 
E.T. (Nightcore) - Katy Perry feat. Kanye West - 
Everytime We Touch (Nightcore) - Cascada - 
I&U (Nightcore) - Rei Yasuda - 
Never Rains (Original Mix) (Nightcore) - Dance R Us - 
Never Rains [Hands Up] (Nightcore) - Dance R Us - 
Only My Railgun (Nightcore) - fripSide - 
Poison (Nightcore) - Alice Cooper - 
Rockefeller Street (Nightcore) - Getter Jaani - 
Say Hello (PreDancer Remix) (Nightcore) - Distinct - 
Waves (Danny R. Radio Edit) (Nightcore) - Dj Satomi - 
Nightcore This - S3RL feat. Tamika - 
Don't Stop (Nightcore) - Foster the People - 
Future Cαndy (Ebon fuwari Remix) (Nightcore) - YUC'e (ゆーしえ) - 
Til Death (Technoposse Remix Edit) (Nightcore) - Til Death - Til Death - 
Til Death (Technoposse Remix) (Nightcore) - Til Death - Til Death - 
Classical VIP - NIGHTkilla - 
NightMaRe - SNoW - 
好き?Suki! - Night Tempo x Tomggg - 好き?Suki! - 
Night Of Fire - Niko - Super Eurobeat, Volume 174 - 
Feeling Good - Nina Simone - Feeling Good: The Very Best of Nina Simone - 
Nite Cruising - Srav3R Feat. Numb 'N' Dub - FÜGENE2 - 
Checkpoint - Nitro Fun and Hyper Potions - Monstercat 027: Cataclysm - 
NMR - Tharu - 
Heartbeat - Nneka - 
Kangpe - Nneka feat. Wesley Williams - No Longer at Ease - 
Breakdown - Noisestorm - 
Machine Gun (16bit remix) - Noisia - Ministry of Sound: The Sound of Dubstep 2 - 
Machine Gun - Noisia - 
Best Smile - nora2r vs. BlackY - Energy Of The Sun - 
CHINATOWN HUSTLER - NOTORIOUS MSG - 
Notorious SNSD (Ben Shepperd Mashup) - The Notorious B.I.G. and SNSD - 
Not Fall in Love with You - Jeff Williams - RWBY: Volume 3 Soundtrack - 
Nou Shou Sakuretsu Girl - Rerulili feat. Kradness - 
Crazy Little Love - Nuage - Super Eurobeat Presents Initial D Final D Selection - 
Counting Stars - Nujabes - Hydeout Productions: 2nd Collection - 
Feather - Nujabes feat. Cise Starr & Akin - Modal Soul - 
Feel So Good - nyankobrq - POPOVER+TEATIME 3 - 
Dragostea Din Tei - O-Zone - Hot Dance 2005 - 
Unity & Emphatic - Obsidia - 
Somewhere over the Rainbow - Israel Kamakawiwo'ole - 
Kuusou Mesorogiwi (空想メソロギヰ) - Yousei Teikoku (妖精帝國) - 空想メソロギヰ - 
Priorities - OHD - 
Say Yea - Older Grand and KBN NoOne - 
Shades Of Grey - Oliver Heldens & Shaun Frank feat. Delaney Jane - 
Voices - Ollie Crowe and Rich James feat. NK - 
完全感覚Dreamer - ONE OK ROCK - 
Op Opps Op - Eureka PSYven - Triple-Q - GANGNAMCORE 2, Part II: ONLY OPPING! - 
rise - ORIGA - Ghost in the Shell STAND ALONE COMPLEX CD-BOX - 
Melbourne Bounce (Deorro Remix) - Orkestrated and Fries & Shine featt. Big Nab - 
End of All (Below) (すべての路の果てに~煉) (English Version) - 森下弘生 - ファイアーエムブレム if ORIGINAL SOUNDTRACK - 
Not Alone - Otto Knows - Urban Dance Vol.19 - 
United (L.A.O.S Remix) - Our Stolen Theory - 
Ghosts Over Baghdad - Outkast vs Deadmau5 - 
X.U. - SawanoHiroyuki[nZk]:Gemie - X.U. | scaPEGoat - 
Paint It Black - The Rolling Stones - Ten Licks From Forty Licks - 
La La La Girl - Paffendorf - 
버드맨 - P-Type (피타입) - 
High Score - Panda Eyes and Teminite - 
Miss Jackson - Panic! at the Disco feat. Lolo - Too Weird to Live, Too Rare to Die! - 
Close Your Eyes for This - Parmalee - Feels Like Carolina - 
Catgroove - Parov Stelar - Samba - 
Let Her Go - Passenger - Toggo Music 34 - 
past days~追憶 - m.o.v.e - INITIAL D BEST SONG COLLECTION 1998-2004 - 
I'm Coming - Pa's Lam System - I'm Coming - 
Patchwork Staccato (ツギハギスタッカート) (JubyPhonic English Cover) - TOA (とあ) feat. Hatsune Miku (初音ミク) - 
Ready Steady Go - Paul Oakenfold feat. Asher D - Bunkka - 
Ready Steady Go (Korean Style) - Paul Oakenfold feat. Asher D - 
I Will Give You My All - Simon Viklund - Payday - The Game Soundtrack - 
Evil Eye - Simon Viklund - PAYDAY 2 Official Soundtrack - 
This Is Our Time - Miles Malone - 
Superstar - Pegboard Nerds and NGHTMRE feat. Krewella - 
The Island, Pt. I: Dawn - Pendulum - Immersion - 
Blood Sugar - Pendulum - Blood Sugar / Axle Grinder - 
Sounds of Life - Pendulum feat. Jasmine Yee - Hold Your Colour - 
The Island (Madeon remix) - Pendulum - Immersion - 
Vengeance - Perturbator - 
All The Things She Said (DnB Remix) - PESS vs t.a.t.u - 
Lost With You - Peter Kiemann feat. Jordi Davis - 
Daydream Cafe (you remix) - Petit Rabbit - 
Englishman in New York - PH Electro - Now That's What I Call Music 01 - 
Gust of Wind - Pharrell Williams feat. Daft Punk - Girl - 
Phase Craze - Israel Medina, Sample Magic & David Felton - 
How It Is - Pheeno feat. Dalvin - 
King for a Day - Pierce the Veil feat. Kellin Quinn - Collide with the Sky - 
PiNK CAT - GARNiDELiA - MIRAI - 
Time of Our Lives - Pitbull and Ne-Yo - 
Nee Lunar Lunar - Platinum Jet - 
LOVE ME - P*Light - Parking Panic EP  - 
P L U S H I E G U N - Doll.ia - 
Beautiful Lies (Nightcore) - B-Complex - 
I My Me Mine (All Star Ver.) - Polysics - 
Pomp and Circumstance / Ifuudoudou - Megurine Luka, Hatsune Miku, IA, GUMI and Kagamine Rin - 
Pop Danthology 2013 - Mashup of 68 songs! - Daniel Kim - 
Fade Away - the sub account - POPOVER+TEATIME 3 - 
Still Alive - Ellen McLain - 
Sad Machine (Darren Styles and Gammer Remix) - Porter Robinson - 
Gangsta's Paradise Cover - Position Music 2WEI - 
Coexist (Jordan Andrew and Nick Anthony Remix) - Prismo - 
Pursuit of Happiness (Steve Aoki remix) - Kid Cudi feat. MGMT & Ratatat - Pursuit of Happiness - 
Roméo et Juliette : Les Montaigus et les Capulets (Dance of the Knights) (Parfum) - Gabriel Prokofiev - Trésors de la pub - 
Cherry Boy Rap Riot - Ken Ashcorp - 
DADDY - PSY (싸이) feat. CL of 2NE1 - 칠집싸이다 - 
Gangnam Style (강남스타일) - PSY (싸이) - The Singles - 
Gentleman - PSY (싸이) - Gentleman - 
Napal Baji (나팔바지) - PSY (싸이) - 칠집싸이다 - 
psychedelic soul - Scott Matthew - Ghost in the Shell STAND ALONE COMPLEX CD-BOX - 
Don't you want me - PSYQUI feat. Such - SPD GAR - 
Hype - PSYQUI Feat. Such - FÜGENE2 - 
Mend Your Ways - PSYQUI feat. Such - Such - innocent - 
Secret Dance Hall - PSYQUI feat. Such - Such - innocent - 
Your voice so...(Zekk's 'FULL SPEC' Remix) - PSYQUI feat. Such - Such - innocent - 
ヒステリックナイトガール (android52 Edit) - PSYQUI feat. Such - 
ヒステリックナイトガール (Awakening) - PSYQUI feat. Such - Such - innocent - 
LOVE&ROLL - PSYQUI feat. Such - Such - innocent - 
Don't you want me (Mameyudoufu Remix) - PSYQUI feat. Such - Such - innocent - 
Hype (sky_delta Remix) - PSYQUI feat. Such - Such - innocent - 
センチメンタルハートボーイ - PSYQUI feat. Such - Such - innocent - 
ヒカリの方へ (lapix & Cranky Remix) - PSYQUI feat. Such - Such - innocent - 
I LUV IT - PSY (싸이) - 4x2=8 - 
New Face - PSY (싸이) - 4x2=8 - 
오빤 딱 내 스타일 - PSY (싸이) feat. HYUNA;  - 
IDGAF (Original Dance Edit) - Punkrockerz feat. Carmen & Camille - 
BOOM! BOOM!! BOOM!!! - P*Light - 
Stargazer (Dj Shimamura Remix) - P*Light feat. Yukacco - 
Qrow vs Winter - Jeff Williams - RWBY: Volume 3 Soundtrack - 
Make It Wit Chu (Virgin Magnetic Material Remix) - Queens of the Stone Age - 
R4V3 B0Y - S3RL feat Krystal - 
Make It Wit Chu (Radio Edit) - Queens of the Stone Age - Make It Wit Chu - 
Nandemonaiya (Movie Version) (It's Nothing) (なんでもないや) - RADWIMPS - Your Name - 
Heart Of Steel - Raiden feat. Bright Lights - 
Dream Lantern (Yume Tōrō) (夢灯籠) - RADWIMPS - Your Name - 
Sweet Surrender - Rameses B feat. Charlotte Haining - 
Quand La Pluie Tombe - nymano - 
O Tebe - Ranetki Girls - 
Anaconda / NYANACONDA (Nyanners Cover) - Nicki Minaj - 
Todestrieb - Rche - beatmania IIDX 19 Lincle ORIGINAL SOUNDTRACK - 
Redstar - Receptor - 
Red Like Roses (Red Trailer) - Jeff Williams (feat. Casey Lee Williams) - RWBY: Volume 1 Soundtrack - 
Red Like Roses Part I II Complete - Jeff Williams feat. Casey Lee Williams - 
Acceleration - REDALiCE - 
Redbone / Redgamers (Gamers vs Childish Gambino) (Triple-Q Mashup Remix) - Childish Gambino and Triple-Q - 
REDLINE DAY - James Shimoji feat. Rob Laufer - REDLINE Original Soundtrack - 
彼のシフトはブンブンブン - James Shimoji feat. SUPER BOINS - REDLINE Original Soundtrack - 
New World - Refeci and Robbie Koex feat. Micah Martin - 
sudo apt-get install RENGE - rekanan - 
Tokio Funka (トキヲ・ファンカ) (Reol (れをる) Cover) - GUMI - Gokusaishiki (極彩色) Tower ver. - 
Derezzed (The Glitch Mob Remix) - Daft Punk - 
Paradisus Paradoxum - MYTH & ROID - 
These Nights - 88rising, Rich Brian & CHUNG HA - Head In The Clouds II - 
Dat $tick - Rich Chigga - Dat $tick - 
Never Gonna Give You Up - Rick Astley - Media Markt Collection: The 80s, Volume 2 - 
ride on technology - Yoko Kanno - Ghost in the Shell STAND ALONE COMPLEX CD-BOX - 
Umbrella - Rihanna feat. JAY-Z - Good Girl Gone Bad - 
Willst Du (radio mix) - Robin Schulz & Alligatoah - Prayer - 
Same - Robin Schulz - Same - 
Heatwave - Robin Schulz feat. Akon - Sugar - 
Heatwave (Hugel remix) - Akon feat. Robin Schulz - Après Ski Club Hits 2017 - 
Kids (Paramond Extended Mix) - Robokids - 
ROCK DA PARTY - Seventhrun and Getty - Infinite Star - 
The Rockafeller Skank - Fatboy Slim - 100 Hits: 90s Pop - 
rog-unlimitation - 07th expansion - 
What Is a Youth (Love Theme From 'Romeo & Juliet') - Nino Rota - Romeo & Juliet - 
Kiss Me Again (Club Edit) - Roy Bee - 
Running in The "90's" - Max Coveri - Super Eurobeat Presents Initial D Special Stage Original Soundtracks - 
Rush Indigo - ak+q - 
Дикi танцi - Руслана - Grand Theft Auto IV: Vladivostok FM - 
Mirror, Mirror Extended - Jeff Williams feat. Casey Lee Williams - 
Armed and Ready - Jeff Williams feat. Casey Lee Williams - RWBY: Volume 4 Soundtrack - 
Bmblb - Jeff Williams feat. Casey Lee Williams - RWBY: Volume 4 Soundtrack - 
Boop (Acoustic Version) - Jeff Williams feat. Casey Lee Williams and Videri String Quartet - RWBY: Volume 4 Soundtrack - 
I May Fall (Harry Lodes Remix) - Jeff Williams feat. Casey Lee Williams - RWBY: Volume 4 Soundtrack - 
Lusus Naturae - Jeff Williams - RWBY: Volume 4 Soundtrack - 
Sacrifice (Harry Lodes Remix) - Jeff Williams feat. Casey Lee Williams - RWBY: Volume 4 Soundtrack - 
It's My Turn (James Landino Remix) - Jeff Williams feat. Casey Lee Williams - RWBY: Volume 3 Soundtrack - 
R.W.B.Y. vs F.N.K.I. - Jeff Williams - RWBY: Volume 3 Soundtrack - 
ODDS&ENDS - ryo (supercell) feat. Hatsune Miku (初音ミク) - ODDS&ENDS - 
Merry Christmas Mr. Lawrence - 坂本龍一 - One World - 
Merry Christmas, Mr Lawrence - Ryuichi Sakamoto - 
Bass Slut - S3RL - Bass Slut / It Went / Crazy Ass Bitch - 
MTC (Different Heaven Remix) - S3RL - 
Pika Girl - S3RL - Super Fun Happy Time - 
Rainbow Girl - S3RL - 
T-T-Techno - S3RL - T-T-Techno / Every Single Day / Stomp Ya Feet - 
Friendzoned - S3RL feat. Mixie Moon - 
I Will Pick You Up - S3RL feat. Tamika - 
It Went - S3RL feat. JessKah - Bass Slut / It Went / Crazy Ass Bitch - 
Mal Hbibi Malou (سعد لمجرد - مال حبيبي مالو) - Saad Lamjarred - 
Mandragora - SaberZ - 
Sad Romance (Sad Violin) (Violin Version) - Ji Pyeongkeyon - 
Further - Sadkey - 
Sad Romance (Voice Ver) - Ji Pyeongkeyon - 
Sad Romance (vvmusic Ver) - Ji Pyeongkeyon - 
Wallflower - Kevin and Carrick - 
Sakasama no Chou - SNoW - 
Independent Puppet - Sakuzyo (削除) - Pop Candy Wonderland - 
Irondust - Sakuzyo (削除) - AngelFalse - 
rePrologue - Sakuzyo (削除) - LAST DANCE - 
The void - Sakuzyo (削除) - AngelFalse - 
Samurai Flamenco Theme - Yusuke Naruse - 
Shiki No Uta (四季ノ唄) - MINMI - アイの実 - 
Shiki No Uta (SparX Beats remix) - MINMI - 
七色アニバーサリー - 桜華P feat. V3 GUMI (Power) - Altemis Heart - 
Sandstorm - Darude - Ahora '01 - 
All MY People - Sasha Lopez and Andreea D feat Broono - 
Save Me (Extended Mix) - Leslie Parrish - Super Eurobeat, Volume 98 - 
Colorful (Asterisk Remix) - Sawai Miku - 
会わないつもりの、元気でね - SCANDAL - Greatest Hits - 
Kagen no Tsuki (下弦の月) - SCANDAL - Greatest Hits - 
Shoujo S (少女S) - SCANDAL - 少女S - 
Shunkan Sentimental (瞬間センチメンタル) - SCANDAL - 鋼の錬金術師 THE BEST - 
Collard Greens - ScHoolboy Q feat. Kendrick Lamar - Oxymoron - 
Ave Maria - Franz Schubert - The Best of Barbara Bonney - 
Sea of Sand (Wipeout mix) - Guy Gerber & Shlomi Aber - Wipeout Pulse - 
119 - Sean & Bobo - 
Swing It - Sean & Bobo - 
Domination (Original Mix) - Sean & Bobo - 
Drop The Bass Low - Sean & Bobo - 
In The Air - Sean & Bobo - 
See you, my best love - m.o.v.e - electrock - 
killy killy JOKER - 分島花音 - killy killy JOKER - 
world's end, girl's rondo - 分島花音 - ツキナミ - 
Senbonzakura - Lindsey Stirling - 
Septette for the Dead Princess - Senya - 
Septette for the Dead Princess (Vocal Orchestra) (永遠に幼き紅い月) - Silver Forest - Silver Forest 2006-2012 BEST2 - 
KIMCIL - SEREMPET GUDAL - 
Setsunairo 1979 - Yuyushiki x The Smashing Pumpkins - 
shadowgraph - MYTH & ROID - shadowgraph - 
Hips Don't Lie (video) - Shakira feat. Wyclef Jean - Oral Fixation, Volumes 1 & 2 - 
CYBER INDUTANCE - DJ Sharpnel - RUNNING ALL NIGHT!! - 
Marble Soda (live mashup) - Shawn Wasabi - 
Uncool Lunch Tables (Skrillex Recess Mashup) - Shawn Wasabi - 
Electric Girl - she - Electric Girl - 
She so Ugly - Kevjumba and Nigahiga - 
Senpai (MajorLeagueWobs Remix) - Shiki(TMNS) feat. Hentai Dude - 
The Final Cypher (Senpai) (Production MajorLeagueWobs) - Shiki(TMNS) feat. etc - 
Senpai - Shiki(TMNS) feat. A.O.Lyrical - 
Who Are You? - Shiki feat. Doll.ia - 
Shine - Jeff Williams feat. Casey Lee Williams - RWBY Volume 2 Soundtrack - 
Shine Spark (Vocal Cover) - VA-11 HALL-A feat. Adriana Figueroa and Garoad - 
Prism - SHINee (샤이니) - 1 of 1 - 
Animetic Love Letter - Aoi Miyamori, Ema Yasuhara and Shizuka Sakaki - 
Home - ShockOne feat. Reija Lee - 
GBA - shoji - 
❤ Bubble Tea Date ❤ - shoji - 
You Reposted In The Wrong Neighborhood (Dunclub Extended Mix) - ＳＨＯＫＫ青 - 
Elastic Heart - Sia - 1000 Forms of Fear - 
The Wolf - SIAMÉS - 
Nobody to Love (extended mix) - Sigma - Nobody to Love - 
Hoppípolla - Sigur Rós - Takk... - 
never gonna stop - simplí feat. Kim Mckenzie - 
SKIP - Chata (茶太) - グリザイアの果実 エンディングテーマ集&オリジナルサウンドトラック - 
Make It Bun Dem - Skrillex & Damian "Jr. Gong" Marley - Make It Bun Dem: After Hours EP - 
Scary Monsters and Nice Sprites - Skrillex - Greatest Hits & Remixes - 
Singshot (Wipeout mix) - Rennie Pilgrem & BLIM - Wipeout Pulse - 
Sulfur Music Video - Slipknot - (sic)nesses - 
Smart Systems - MIST - Wipeout Pulse - 
Butterfly - Smile - Smile - 
Love Residue - SMLE feat. Jackie's Boy - 
Candy Dash - Ujico* /Snail's House - CandyGirl - 
雪の降る街で、あなたを待っている。 (waiting for you, in snowing city.) - Snail's House - Snö - 
Pastel - Snail's House × Moe Shop - 
Rhythm Is a Dancer - Snap! - Fetenhits: Silvester 2014 - 
Snoop Dogg (Explicit) - Snoop Dogg - Snoop Dogg / Back Up Ho - 
soda city funk - Tim Legend - soda city funk - 
Tainted Love - Soft Cell - Smash Hits Party - 
Honolulu how do you do - Sol K. Bright's Hollywaiians - 
Something Stupid - Nancy Sinatra - Nancy Sinatra and Friends - 
Solitude - nymano - 
Song of Storms (dubstep remix) - Ephixa - Zelda Step - 
Bi☣hazard VOCALOID Cover - SONiKA - 
Move That Body -Extended Mix- - Sota Fujimori - SYNTHESIZED5 - 
monochrome (Asterisk Makina Remix) - Asterisk - Asterisk Works 3 - 
Moonlight Ginga (ムーンライト銀河) - Sōtaisei Riron (相対性理論) - シンクロニシティーン - 
Murder - Soulji - Black Mask EP - 
Space-Time - S3RL feat. Riddle Anne - 
Sigmund - Gram - beatmania IIDX 21 SPADA ORIGINAL SOUNDTRACK VOL.2 - 
Song of Storms - 
Crossroads (Fusq remix) - Sparx - 
HERO (히어로) - MONSTA X (몬스타엑스) - RUSH - 
Black Betty - Spiderbait - 
Spoiler Alert - S3RL feat. DEFI BRILATOR - 
Let Me Hit It (Audiostalkers mix) - Sporty-O - Let Me Hit It - 
「JUST ONE LIFE」（フジテレビノイタミナアニメ「サムライフラメンコ」オープニング・テーマ）  - SPYAIR - 
Speed Complex - Srezcat & Kobaryo - ABSOLUTE - 
Bassdrum Catharsis - Srezcat & Kobaryo - METAMORPHOSE - 
Pizza Rolls - Shawn Wasabi / sssShawnnnn - PIzza Rolls - 
Pizza Rolls (metal x EDM mashup) - Shawn Wasabi - 
Hold On - St. Albion feat. Teischa - 
5 Centimeters Per Second - Star Driver - 
I Was the Sun (Before it was Cool) - Curtis Schweitzer - Starbound - 
Music Sounds Better With You - Stardust - Fresh FM 90's Dance! - 
Starstruck - Lady Gaga feat. Space Cowboy & Flo Rida - Disco Heaven: The Fame B=2.0 - 
#StartAgain - OllyP - 
Steady Rush - BOOKA SHADE - Wipeout Pulse - 
Commodus Pt.1 (The Arrival) - Stefan Nixdorf - 
Commodus The Menace (Pt.2) - Stefan Nixdorf - 
Dedenne - Stepic - 
夕暮れスターライド - Stereoman - POPOVER+TEATIME 3 - 
Future Cαndy (Stereoman Remix) - YUC'e (ゆーしえ) - 
Hitohira no Hanabira - Stereopony - Japan Nite Sound Sampler 2009 - 
Show Me Love - Steve Angello & Laidback Luke feat. Robin S. - The Biggest Breakdowns of All Time - 
Englishman in New York - Sting - Millennium Gold - 
Be Alright - Stonebank feat. EMEL - Monstercat 027: Cataclysm - 
Put 'em High - Stonebridge feat. Therese - 
Stranger Bonfires - kmlkmljkl - 
stranger_think - C418 - 2 years of failure - 
Tous les mêmes - Stromae - Racine carrée - 
Let's Go - Stuck in the Sound - Pursuit - 
Party Like It's Your Birthday - Studio Killers - Party Like It's Your Birthday - 
Syrup - Stwo - 
STYX HELIX (dj-Jo Remix Extended) - MYTH & ROID feat. Akano  - 
Intracerebral Synapse Rebellion (脳内シナプスの叛逆) - KagomeP feat. Hatsune Miku (初音ミク) - 
Changes - Suken and Fusq - Owarini Tokyo Liveshow  - 
Kimino Shiranai Monogatari - Supercell - 
LOVE & ROLL - supercell - Today Is A Beautiful Day - 
Parade of liars (嘘つきのパレード) (Usotsuki no paredo) (Band Edition) - supercell - 
Surfing on a Sine Wave - Fearofdark - Motorway - 
See You - Sushi Killer - 
Waifu Dream - Sushi Killer - 
Zora (Live Mashup) - Sushi Killer - 
Pony Swag - Swagberg feat. Maros - 
Miami 2 Ibiza - Swedish House Mafia vs. Tinie Tempah - Disc-Overy - 
Antidote (radio edit) - Swedish House Mafia & Knife Party - Antidote - 
Sweet Devil (colate Remix) - Hachioji-P (八王子P)/8#Prince feat. Hatsune Miku (初音ミク) - 
Right Back - SWRVN x Razz - 
Anti-HeroiK - Synagi - Krazy Psycho Bass 2 - 
Strangers - Synchronice - 
Lights (Cross Them Out Remix) - System feat. Veela - 
TV Tokyo (テレ東) - Sōtaisei Riron (相対性理論) - ハイファイ新書 - 
Vermont Kiss (バーモント・キッス) - Sōtaisei Riron (相対性理論) - ハイファイ新書 - 
Hell Teacher / Jigoku Sensei (地獄先生) - Sōtaisei Riron (相対性理論) - ハイファイ新書 - 
Call me it. (500 Tortures) - t+pazolite - 
(The title is) TOO LONG to write here. - t+pazolite - Bright Colors - 
cheatreal - t+pazolite - Answer from X Girlz - 
Kick-ass Kung-fu Carnival - t+pazolite - Hardcore Syndrome 5 - 
Ultrasonic Anthem - t+pazolite - Voltage Ignition 2 - 
All the Things She Said - t.A.T.u. - Now Dance 2003 - 
Drip Drop - TAEMIN (태민) - Press It - 
take me higher - m.o.v.e - electrock - 
Tank! - シートベルツ - COWBOY BEBOP - 
reunion <Platinum Long Version> - Tatsh - MATERIAL - 
Emotions (キドアイラク) - Task feat. Hatsune Miku (初音ミク) - 
I Knew You Were Trouble - Taylor Swift - 
Nas Ne Dogonyat (Нас не догонят) - t.A.T.u. - 200 km/h in the Wrong Lane - 
Shake It Off (Music Video) - Taylor Swift - Shake It Off - 
Head Over Heels - Tears for Fears - The Ultimate Collection - 
Dysfunctional - Tech N9ne feat. Big Scoob & Krizz Kaliko - Collabos: Sickology 101 - 
Promesses (radio edit) - Tchami feat. Kaleem Taylor - Ministry of Sound: Back to Bass - 
Worldwide Choppers - Tech N9ne - 
IMAGE -MATERIAL- (Version 0) - Tatsh - 
Fly Away (Fusq Remix) - TeddyLoid - 
Capture My Attention - TeeTs - 
Broken String - Tek-One - Ministry of Sound: The Sound of Dubstep - 
Tell Me What You Want - S3RL feat. Tamika - 
Lean Back - Terror Squad - Black Winter Party - 
The Light (Original Mix) - Tetrix Bass feat. Veela - 
Sugar, Sugar - The Archies - The 60's Decade: Number One Hits - 
Rock That Body - The Black Eyed Peas - Radio 538 Hitzone 53 - 
Warp 1.9 - The Bloody Beetroots - Warp - 
Swoon (Boys Noize Summer Mix) - The Chemical Brothers - 
Swoon (radio edit) - The Chemical Brothers - The Chemical Brothers - 

Our Demons - The Glitch Mob feat. Aja Volkman - 
We Can Leave the World - Boppin' B - We Can Leave the World - 
Future Starts Slow - The Kills - Festival La Route du Rock, la Compilation 2011 - 
Falco - Hitomi Shimatani - 
California Dreamin' - The Mama's and the Papa's - If You Can Believe Your Eyes and Ears - 
LAST DINOSAUR - the pillows - HAPPY BIVOUAC ON THE HILLARI STEP - 
Ragnarok - Gram vs Camellia (かめりあ) - The Requiem - 
Scatman - Scatman John - Chart Busters: 40 Mega Hits - 
1979 - The Smashing Pumpkins - 1979 - 
The Sound of Silence - Art Garfunkel - Up 'til Now - 
The Top - Ken Blast - Super Eurobeat Presents Initial D Final D Selection - 
Untouched - The Veronicas - Miss Independent: From the Ladies of Pop - 
Seven Nation Army - The White Stripes - Triple J: Hottest 100 of All Time - 
Shikaku Kakumei (四角革命) - Sōtaisei Riron (相対性理論) - ハイファイ新書 - 
The House of the Rising Sun - The Animals - The Animals - 
Jungle - The Brig - 
Closer - The Chainsmokers feat. Halsey - Closer - 
Tell Him - The Exciters - Rock, Rhythm and Doo Wop: The Greatest Songs From Early Rock 'n' Roll - 
Superman - The Lucky Laki - 
THE MILLION-YEAR PICNIC - CaptainMirai (キャプテンミライ) feat. lasah - INNOCENCE - 
The Real Disappearance of Hatsune Miku - cosMoBousou-P feat. GUMI - 
This is Genius level Hiphop - Ohene Savant - 
This Life is Mine - Jeff Williams feat. Casey Lee Williams - RWBY: Volume 4 Soundtrack - 
This Will Be the Day - Jeff Williams (feat. Casey Lee Williams) - RWBY: Volume 1 Soundtrack - 
This Will Be the Day (James Landino's Magical Girl Remix) - Jeff Williams feat. Casey Lee Williams - 
Booka Shake (Original Mix) - Thomas Jack - 
Inspire - Throttle - Throttle - Inspire - 
Through the Years 2018 - S3RL & Zero-2 feat. Yurino - 

Time To Say Goodbye - Jeff Williams feat. Casey Lee Williams - 
Time to Say Goodbye (Acoustic) - Jeff Williams feat. Casey Lee Williams - RWBY: Volume 3 Soundtrack - 
Freaks (radio edit) - Timmy Trumpet & Savage - Freaks - 
Written in the Stars - Tinie Tempah feat. Eric Turner - Bravo Black Hits, Volume 23 - 
Pass Out - Tinie Tempah - Now That's What I Call Running 2014 - 
Written in the Stars - Tinie Tempah feat. Eric Turner - Bravo Black Hits, Volume 23 - 
to Luv me I *** for u. - t+pazolite - HARDCORE SYNDROME 2 - 
Makudonarudo (東京盆踊) - Namewee (黃明志) feat. Meu Ninomiya (二宮芽生) - 亞洲通吃 - 
Tokyo Drift (Fast & Furious) - Teriyaki Boyz - Serious Japanese - 
Tokyo - Stanton Warriors - Wipeout Pulse - 
Sex Bomb - Tom Jones - 
What's New Pussycat - Tom Jones - 
Where It Hurts - Tom Reev, Assix, and Jason Gewalt - 
Danger (The Bomb) - Tonite Only - 
We Run The Night - Tonite Only - 
Where the Party's At - Tonite Only - Ministry of Sound: The 2007 Annual - 
Stay High (Habits remix) - Tove Lo feat. Hippie Sabotage - NRJ Music Awards 2014 - 
diskommunication - t+pazolite - Answer from X Girlz - 
CENSORED!! - t+pazolite - t&T. "tpz And TOUHOU" from 2005 - 
Oshama Scramble! (uncut edition) - t+pazolite - Ponko2 Girlish - 
Kick-ass Kung-fu Carnival (RoughSketch Remix) - t+pazolite - 108 Sketches 5 - 
Howling Down - t+pazolite - songs for X Girlz - 
Datamania - t+pazolite - IRREGULAR NATION 4 - 
Must Be Done - t+pazolite - TRI▼FORCE - 
TENO-HIRA - CaptainMirai (キャプテンミライ) feat. lasah - "I LOVE YOU," - 
Fast Car - Jonas Blue feat. Dakota - Radio 538 Hitzone 76 - 
Mission ASCII - Traktion - 
Military Storm - Dj Bjra / Trance - 
Flying High (DJ Splash Remix Nightcore) - DC-10 (DCX) - 
Transparent Elegy - n-buna and GUMI - 
Sega Genesis - Trevor Something - 
Ochansensu-su (おちゃんせんすぅす) - tricot - T H E - 
Tsubasa wo Kudasai (翼をください) (Cover) - Yandere Dev - 
Tsubasa wo Kudasai (翼をください) - Megumi Hayashibara (林原めぐみ) - EVANGELION:2.0 YOU CAN (NOT) ADVANCE. original sound track - 
Dr. Who! (Smooth remix) - Tujamo & Plastik Funk feat. Sneakbo - Viper presents: Drum & Bass Summer Slammers 2014 - 
Ravers Fantasy - Manian - Club Sounds: The Ultimate Club Dance Collection, Volume 49 - 
Horns Up - Tuzulto X Stompede - 
Epiphany - TwoThirds and Feint - 
How I Feel - Tyler Cassidy - 
U.N. Owen Was Her? (Batsu Remix) - Batsu - 
dreamenddischarger - GranMusik - TVアニメーション 「うみねこのなく頃に」 Original Sound Track ~Rose Crimson~ - 
U.N.オーエンは彼女なのか? - TAMUSIC - 東方バイオリン7 - 
Everthing Will Freeze - Undead Corporation - 
Yoru Naku Usagi wa Yume wo Miru (紅染の鬼が哭) - Undead Corporation - 
Once Upon a Time (Arcien Remix) - Toby Fox - 
Dream Catcher - Unicorn Kid - Sound Of The Summer - 
Out of Touch - Uniting Nations - Jetix Vakantiehits 2005 - 
Beautiful Light - Uppermost - Control - 
Sakura Era - USAO - Kick's For Liberation - 
Vacuum Break - USAO - Kick's For Liberation - 
Hop Step Instant Death A Happiness Dance Death-Trap - UtataP feat. 初音ミク - 
Lubricates - V e g e t a b l e s - 
Your Love is a Drug (insaneintherain Arrange) (Vocal Cover) - VA-11 HALL-A feat. Adriana Figueroa - 
Your Love is a Drug (Vocal Cover) - VA-11 HALL-A feat. Sabrina Valenzuela - 
Make Me Fade - Vanic x k.flay - Make Me Fade - 
Can't Sleep - Vanic x K.Flay - Can't Sleep - 
My New Swag - VaVa feat. Ty & Nina Wang - Crazy Rich Asians: Original Motion Picture Soundtrack - 
Ven báilalo - Angel y Khriz - Caribe 2005 - 
Hajnal - Venetian Snares - Rossz csillag alatt született - 
Vida - Venetian Snares - D-Side 23 - 
Boom, Boom, Boom, Boom - Vengaboys - Sunshine '99 - 
Biddie Bounce - Venice - 
Jag kommer - Veronica Maggio - More Music 2012 - 
Kurt Cobain - Veronica Maggio - Fiender är tråkigt - 
Måndagsbarn - Veronica Maggio - Big Hits - 2009 - 
Tillfälligheter - Veronica Maggio - Fiender är tråkigt - 
Heartbeat - Vicetone feat. Collin McLoughlin - 
Perjuangan - Vierratale feat. Ilyas *Kevin and the Red Rose" - 
Petit Girlfriend - ViZ0R (SOUNDSCVPE) - 
Party x Party - Vocaloid Six - 
Half Step - livetune feat. 初音ミク - Tell Your World EP - 
(Vocal) you - 霞ヶ丘詩羽(CV.茅野愛衣) - 冴えない彼女の育てかた 第4巻 特典CD - 
Superstar (Original Mix) - Vonikk - 
Wait For The Moment - Vulfpeck feat. Antwaun Stanley - 
Revenge of Nautilus - Vøldø - 
Cari Jodoh - Wali - Cari Jodoh - 
Walk It Talk It Kiss It (Triple-Q Mashup) - Darling in the FranXX vs. Migos & Drake and Triple-Q - 
Are You Bored Yet? - Wallows feat. Clairo - Nothing Happens - 
King of my castle - Warmdue Project - 
Wanna fly to be wild - m.o.v.e - electrock - 
我的歌声里 (You Exist in My Song) - Wanting - Everything in the World - 
Ancient Warrior - Warptech - 
Cherry Pie - Warrant - The Rock and Roll Decades: The Nineties - 
Waters of Megalovania - BotanicSage - 
Bump & Grind - Waze & Odyssey vs. R. Kelly - 
More Bounce (In California) - Soul Kid #1 - Legally Blonde 2: Red, White & Blonde - 
Weapon of Choice - Fatboy Slim - Star 69 (What the F**K) / Weapon of Choice - 
Amish Paradise - "Weird Al" Yankovic - The Essential "Weird Al" Yankovic - 
White & Nerdy - "Weird Al" Yankovic - Absolute Music 53 - 
ID - What So Not - 
Touched - What So Not - 
what's it for - Emily Curtis - Ghost in the Shell STAND ALONE COMPLEX CD-BOX - 
What Lies at the End - Takeru Kanazaki (金﨑猛) - Fire Emblem Echoes: Shadows of Valentia Original Soundtrack
 - 
What Redbone would sound like if X Gon Give It To Ya (Redbone and X Gon' Give It To Ya Mashup) - Childish Gambino and DMX - 
When I Die - S3RL feat. Razor Sharp and Krystal - 
When It Falls - Jeff Williams feat. Casey Lee Williams - RWBY: Volume 3 Soundtrack - 
Where Did You Go - S3RL feat. Charlotte - 
Whirlwind - S3RL feat. Krystal - 
Why'd you only call me when you're high - Arctic Monkeys - 
Windowlicker 33 RPM Vinyl (slow) - Aphex Twin - 
Acetone - The Crystal Method - Wipeout HD Fury - 
Le Night Dominator - The Touch - Wipeout HD Fury - 
World's End, Girl's Rondo (Asterisk DnB Remix) - Kanon Wakeshima - 
What You Want - Wizard and Matbow -  - 
Black And Yellow - Wiz Khalifa - The Chronic 2010 - 
House of the Rising Sun - Wilbert Eckart und seine Volksmusik-Stars - Wolfenstein: The New Order Original Game Soundtrack, In-Game Music - 
Hook Shot - Wolfgang Gartner - Kindergarten - 
Illmerica - Wolfgang Gartner - DefQon.1 2011 - 
The American Epic (PrototypeRaptor Bootleg) - Wolfgang Gartner - 
Clap - Wolfgang Gartner - Kindergarten - 
About the Dutch - Woodie Smalls - De Maxx Long Player 35: The Remix Edition - 
k1ll◎iLL - 澤野弘之 - KILL la KILL ORIGINAL SOUND TRACK - 
Need Your Love - Wreckless and Rivo - 
Little Too Close - WRLD feat. Veronika Redd - Monstercat 024: Vanguard - 
FREEDOM DiVE↓ - xi - Parousia - 
Happy End of the World (ハッピーエンドオブザワールド) - xi - Agartha - 
I kinda just wish it would disappear (消えてしまえたならいいのに、なんて) - Xotic Kamatani ft. Hatsune Miku (初音ミク) - 
Bochka, Bass, Kolbaser (Бочка, Басс, Колбасер) - XS Project - Гоп FM: Pump - 
Siuda Kalatuszek - XS Project - 
LAX - Xzibit - Weapons of Mass Destruction - 
Harumodoki - Nagi Yanagi - 
Venus to Jesus (ヴィーナスとジーザス) - Etsuko Yakushimaru (やくしまるえつこ) - RADIO ONSEN EUTOPIA - 
Haru Modoki x Invitation - Nagi Yanagi - 
BLACK RAIN - Yashiro Tsurugi (CV Yoshimasa Hosoya)(剣弥代(CV.細谷佳正)) - 幻影異聞録♯FE ボーカルコレクション - 
Yatsuzaki (The Northern Hardcore) (Komarovski remix) - Quil feat. DD"ナカタ"Metal - The Far East Hard Session - 
Ya soshla s uma (Я сошла с ума) - t.A.T.u. - 200 km/h in the Wrong Lane - 
Drink Up - YeahRight feat. Azuria Sky - 
River Flows In You (A Love Note) (Original Mix) - Yiruma & Skullee - 
River Flows in You - 이루마 - 아기의 감성지수(EQ)를 높이는 피아노 태교음악 - 
The Fox (What Does the Fox Say) - Ylvis - Hitbreaker 2/2014 - 
YMCA - Village People - FriendsReunited.co.uk '70s Party - 
Lucky Batch - you - Lilium X4 - 
YOU'RE EVERYTHING - Dark Cat feat. juunana - 
You Reposted in the Wrong Neighborhood - ＳＨＯＫＫ青 - 
PUMP - YUC'e (ゆーしえ) - FÜGENE - 
Cappchino - YUC'e (
ゆーしえ) - macaron moon - 
Cinderella Syndrome - YUC'e (ゆーしえ) - Future Cαndy - 
Future Cαndy (Dream Hackers Remix) - YUC'e (ゆーしえ) - 
Future Cαndy (Huichang Remix) - YUC'e (ゆーしえ) - 
Future Cαndy (Daniel Seven Remix) - YUC'e (ゆーしえ) - 
Future Cαndy (Snail's House Remix) - YUC'e (ゆーしえ) - 
macaron moon - YUC'e (ゆーしえ) - macaron moon - 
Night Club Junkie - YUC'e (ゆーしえ) - macaron moon - 
Sengoku HOP (戦国HOP) - YUC'e (ゆーしえ) - Athenarium  - 
Summer Lover!! - YUC'e (ゆーしえ) - Toy Frappe - 
Sunset Tea Cup - YUC'e (ゆーしえ) - FREQUENCY BLITZ 5 - 
Tick Tock - YUC'e (ゆーしえ) - Future Cαndy - 
Future Cαndy (Xignality Remix) - YUC'e (ゆーしえ) - 
Tsubasa wo Kudasai (翼をください) - YUI - 
かくしごと - ゆいこんぬ - 虹色ショコラティエ - 
Strawberry Karte (すとろべりーカルテ) - Yunomi feat. Momobako (桃箱) - 
Indoor Kei Nara Trackmaker (インドア系ならトラックメイカー) - Yunomi and nicamoq - 
Yakimochi no Kotae -another story- - Yuikonnu - 
ダンスフロアの果実 - Yunomi feat. nicamoq - 
SHINY DAYS - Asaka (亜咲花) - SHINY DAYS - 
Runnin Around (Favulous Remix) - Zak Waters - 
Poltergeist - Zatox feat. Nikkita - Raw Style EP - 
Stay the Night - Zedd feat. Hayley Williams of Paramore - Stay the Night - 
Midnight Sweet - Zekk - 
Kernkraft 400 - Zombie Nation - Megahits 2000: Die Erste - 
Blackjack - ゆちゃP feat. 巡音ルカ - EXIT TUNES PRESENTS Megurhythm - 
Akasagarbha - wa. vs Etia. - 
Le Disco - Henry Fong - 
Romeo and Cinderella - CUL - 
プレインエイジア (Plain Asia) - Dark PHOENiX - Arrow Rain - 
Homebound - Feint - Monstercat - The Best of 2013 - 
Snake Eyes - Feint feat. CoMa - Monstercat - Best of DnB & Drumstep, Vol. 2 - 
Timeless - Rameses B feat. Veela - Monstercat 015: Outlook - 
All Alone - Pegboard Nerds & Grabbitz - Monstercat 026: Resistance - 
Razor Sharp - Pegboard Nerds & Tristam - Razor Sharp - 
Frightmare - Strangers feat. Myles Travitz - 
Pressure - Draper feat. Laura Brehm - Monstercat 021: Perspective - 
Moving On - Stonebank feat. EMEL - Monstercat 018: Frontier - 
如月アテンション - じん feat. 春奈るな - メカクシティアクターズ 2「如月アテンション」 - 
ヤキモチの答え - HoneyWorks feat. 望月蒼太(CV:梶裕貴) - 僕じゃダメですか? - 
Daia no Hana (ダイアの花) - Yorico (より子) - second VERSE - 
ロミオとシンデレラ - Doriko feat. 初音ミク - ベスト '07-'09 Impacts - 
Anime Bae - Sushi Killer & Kevin Villecco - Monstercat 019: Endeavour - 
Pizza Planet - Stephen Walking - Monstercat - The Best of 2013 - 
Chemical Emotion ケミカルエモーション - GUMI and Rin - 
KiLLER LADY - 8#Prince feat. GUMI - ×××× the ripper - 
人生リセットボタン (Jinsei Reset Button / Life Reset Button) - kemu feat. GUMI - Happy Party☆彡 - VOCALOID(tm)3 Megpoid(GUMI) - - 
Stronger - Stonebank feat. EMEL - Monstercat 021: Perspective - 
Just Another Night (Nightcore) - Icona Pop - 
Vitality (t+pazolite Remix) - Mittsies - 
Tonight - Stereotronique & Sebastian Ivarsson feat. Danyka Nadeau - Monstercat 012: Aftermath - 
dawn - kamome sano - Oriens/dawn EP - 
ERROR [VOCALOIDカバー] - IA - 
Marie-Luise - Lily - 
Scarlet Rose - Lily - 
Narcissus - 
Party Junkie - さつき が てんこもり feat. Hatsune Miku (初音ミク) - V♥25 -Exclamation- - 
Awoo - 김예림 - Simple Mind - 
광화문 (Gwanghwamun) - P-Type ft. 태완 (Taewan) - Street Poetry - 
Mr. (ミスター) - KARA (카라) - スーパーガール - 
アシンメトリー (Asymmetry) - ギガP (Giga-P) feat. れをる (Reol) & L.Petty - No title- - 
Chase It - WRLD feat. Savoi - Monstercat 023: Voyage - 
Heads Will Roll (A-Trak Remix) - Yeah Yeah Yeahs - Heads Will Roll - 
TRIGGER★HAPPY (Extend Ver.) - P*Light - HAPPYMAKER - 
BLACK or WHITE? - BlackYooh vs. siromaru - SOUND VOLTEX ULTIMATE TRACKS -LEGEND OF KAC- - 
Selection Of Life - TeddyLoid - Electric Alice - 
威風堂々 - 梅とら feat. 巡音ルカ、初音ミク、GUMI、IA、鏡音リン&MAYU - EXIT TUNES PRESENTS Vocalofuture - 
WAVE - vocaloid chorus - 
This Is Rock 'n' Roll - [X]-Rx - Update 3.0 - 
Internet bitch P*Light Remix - DJ'TEKINA//SOMETHING - DJ'TEKINA//SOMETHING - 
Tear Rain - えみぃ - Radical Destruction - 
(Plus Danshi) - Reol (れをる) - 
寄明月 (三无&泠鸢yousa Cover) - SING女團 - 
Anchor (Noisestorm remix) - Tritonal - Anchor (remixes) - 
All the Things She Said (TOXiC Remix) - T.A.T.U - 
Collide - Fractal feat. Danyka Nadeau - Gaia - 
Waifu Dream (Ephixa Remix) - Sushi Killer  - 
Love Doll ラブドール 【UTAUカバー】 - Gahata Meiji - 
IMAGINARY LIKE THE JUSTICE - GUMI - 
Parade of Liars (嘘つきのパレード) - supercell feat. Hatsune Miku (初音ミク) - supercell - 
iNSaNiTY (feat.SF-A2 miki&KAITO) - Circus-P - iNSaNiTY -EP DLX - 
SEE THE LIGHTS - IA feat. Asy - 
六兆年と一夜物語 - kemu feat. IA - IA THE WORLD ~風~ - 
FUNKY SUMMER BEACH - P*Light - jubeat saucer ORIGINAL SOUNDTRACK -7 Bros.- - 
いちぬけ / 能登麻美子 (Ichi Nuke) - 能登麻美子 (Noto Mamiko) - 地獄少女 三鼎 オリジナルサウンドトラック~肉喰~ - 
Dialing Paranoia - IA - 
Love is War (恋は戦争) - supercell feat. Hatsune Miku (初音ミク) - supercell - 
Transparency Elegy - Ouka Alice - 
When the First Love Ends - Hatsune Miku - 
WAVE - Lily - 
You (Vocal) - 癒月 - Thanks/you - 
Super Nuko World - Yuikonnu and Ayaponzu - 
All Right - Lim Kim (김예림) - A Voice - 
only my railgun (カラオケ) - fripSide - only my railgun - 
Senbonzakura (千本桜) - Kurousa-P (黒うさP) feat. Hatsune Miku (初音ミク) - EXIT TUNES PRESENTS Vocalodream - 
FIRST (UTAU cover) - 重音テト - 
Miss You - Nhato - Stir Up Club Edition V3 | diaphanser - 
God knows... - 平野綾 - AYA MUSEUM - 
World is Mine (ワールドイズマイン) - supercell feat. Hatsune Miku (初音ミク) - supercell - 
花は幻想の果てに - Halozy - Halozy Alternative Outside 2010 Winter - 
Hasty Boom Alert - μ-Ziq - Lunatic Harness - 
αcquainτed - dante - 
i ωɒN̂t iẗ ThÅt ωay (i want it that way) - ΔMUNOA - Culture - 
Tatarin (Татарин) - Aigel (Аигел) - 1190 - 
На стиле - Время и Стекло - На стиле - 
Ju-Ju (Жу-Жу) - Leningrad (Ленинград) feat. Gluk’oZа (Глюк'oZa), ST - Жу-Жу - 
Даже Не Половина - Zomb (Зомб) - 
Ju-Ju (Жу-Жу) - Leningrad (Ленинград) feat. Gluk’oZа (Глюк'oZa), ST - Жу-Жу - 
Я КРОКОДИЛ (LACOSTE) - Stas Exstas (СТАС ЭКСТАЗ) - 
Я КРОКОДИЛ (OFFICIAL STREET VIDEO) - Stas Exstas (СТАС ЭКСТАЗ) - 
раз раз раз-это Hardbass (Хард Басс) - Dj Железные Шарниры - 
Sayonara детка - Элджей feat. Era Istrefi - Sayonara детка - 
I Walk Alone (Nightcore) - Crystal Lake vs Commercial Club Crew - 
Shinkai Shoujo (深海少女) (Chorus) (multiple people) - Nico Nico Chorus (合唱) - 
Senbon Zakura 千本桜 - kran - 
No Regret - 倖田來未 - Complete Best - 
好想爱这个世界啊 - 华晨宇 - 新世界NEW WORLD - 
No title - Giga-P(ギガP) feat. Reol (れをる) - No title- - 
x.U. (ETIA. Hardcore Bootleg Remix) - Hiroyuki Sawano - 
Future Cider - YUC'e (ゆーしえ) - EDP presents ravemania speed - 
Maple Fantasy - Assertive - VIVID HARDCORE -New Season- 4 - 
enhancer (2017 rework) - kamome sano - enhancer EP - 
Hurricane - Seventhrun - J-NERATION 8 - 
Future Cαndy - YUC'e (ゆーしえ) - Future Cαndy - 
MOMO SYRUP - Nor + YUC'e - MOMO SYRUP - 
ヒステリックナイトガール - PSYQUI feat. Such - STYLEY! - 
Pomp and Circumstance (Ifuudoudou) (威風堂々) (Nhato Remix) - 梅とら - EXIT TUNES PRESENTS Entrance Dream Music3 - 
Reversible Campaign (「リバーシブル・キャンペーン) (Rurutia Dariya / roux Cover) - DECO*27 - 
Pomp and Circumstance / Ifuudoudou (威風堂々) (柿チョコ Cover) - Megurine Luka, Hatsune Miku, IA, GUMI and Kagamine Rin - 
JINGO JUNGLE (ESTA Remix)  - MYTH & ROID - 
Pure Furies ~ Vengeance is Mine (ピュアヒューリーズ ~ Vengeance is Mine) - Demetori (東方アレンジ) - Determinism&DestruKction - 
Dancing Wildly (狂喜乱舞) (柿チョコ Cover) - Megurine Luka, Hatsune Miku, and GUMI - 
INSOMNIA - whoo feat. lasah - INNOCENCE - 
Eclipse - Powerless - pulvis et cinis - 
Out In Middle - lapix - PsyStyle Nation - 
Orange Mocha Frappuccino - t+pazolite - 108 Sketches 5 - 
FIRESTARTER - D.watt - バズリズシ ～I-O-P SELECTED vol.04～ - 
Fly Away Now - Ryunosuke Kudo and aran - CIERA - 
4 U Rave And Roll  - DJ Shimamura - EDP presents ravemania speed - 
Make Believe - Ryunosuke Kudo (工藤龍之介) - Honey Cheeks 2 -Purple Dress- - 
Akasagarbha (Hardcore Mix) - ETIA. vs wa. - 
RIP in the Gossip Sea - cosMo feat. GUMI - 
Virtual Paradise - Aljosha Konstanty, Veela & Lynx - [non-album tracks] - 
Renegade (Dub Elements Remix) - Eyes of Providence - 
If You Hadn't - KOAN Sound X Culprate X Asa X Opiuo - 
Go Go Ghost Ship (ゴーゴー幽霊船) - Kenshi Yonezu (米津玄師) - diorama - 
Donut Hole (ドーナツホール) - GUMI - 
Ghost in the Hell - Hanyuu Maigo feat. Hatsune Miku (初音ミク) - 
Living with Depression - Yanaga Miyuki feat. Hatsune Miku (初音ミク) - 
Patchwork Staccato (ツギハギスタッカート) - TOA (とあ) feat. Hatsune Miku (初音ミク) - EXIT TUNES PRESENTS Vocalofantasy - 
Patchwork Staccato (ツギハギスタッカート) (Hyu Cover) - TOA (とあ) feat. Hatsune Miku (初音ミク) - 
Shooting Star - TeddyLoid feat. IA - IA/03 -VISION- - 
Party A - DJ Genki - A/LOG:02 - 
メテオシャワ - DJ Shimamura feat. アイロボ - 
nocturne - DJ Noriken - Omnifarious - 
えれくとりっく・えんじぇぅ - ななひら/れをる - ぎがばなな ざ べすと 〜NORISHIO味〜 - 
Suki Kirai (スキキライ) (GigaP (ギガP) Remix) - HoneyWorks feat. Kagamine Rin (鏡音リン), Kagamine Len (鏡音レン) - 六弦アストロジー - 
Hate-Girl - Kairiki Bear feat. Hatsune Miku (初音ミク) - 
Suki Kirai (スキキライ) (GigaP (ギガP) Remix) - HoneyWorks feat. Megurine Luka (巡音ルカ), Hatsune Miku (初音ミク) - 六弦アストロジー - 
Alien Alien (エイリアンエイリアン) - NayutalieN (ナユタン星人) - 
3331 歌ってみた。 - nameless - 
Never Rains (Nightcore) - Dance R Us - 
Nobody Makes Sense - Pinocchio-P feat. Hatsune Miku (初音ミク) - 
MAD HEAD LOVE - Kenshi Yonezu (米津玄師) - YANKEE - 
Sakura Mirage (Extended Mix) - Ryu☆ - Seventh Heaven - 
Egoist - Shero feat. Hatsune Miku (初音ミク) - 
とびだせ!バンキッキ(Casual Killer remix) - Shibayan Records - Sedecim - 
Dear you -Kind- - 雪宮雛希 - Dear you 「ひぐらしのなく頃に」イメージボーカルアルバム - 
Shut Uppp Love - YM feat. GUMI - 
Get Down - Getty - Kirara Anthems vol.2 - 
Dancing Wildly (狂喜乱舞) (Cover) - Megurine Luka, Hatsune Miku, and GUMI - 
Deep Sea Girl (深海少女) (Nobunaga Cover) - Hatsune Miku (初音ミク) - 
you - Visionen im Spiegel - 癒月 - ひぐらしのなく頃に イメージアルバム かけらむすび - 
You (Vocal) - 癒月 - Thanks/you - 
Tougen Renka (桃源恋歌) - GARNiDELiA - 
Gokuraku Jodo (極楽浄土) - GARNiDELiA - 約束 -Promise code- - 
Kyoukiranbu (響喜乱舞) - GARNiDELiA - 響喜乱舞 - 
ニュース39 - Mitchie M feat. 初音ミク - 39D - 
Alcoholman (알콜맨) - Stella Jang - 유해물질 - 
tractrix - Soh Yoshioka feat. Hatsune Miku (初音ミク Append) - EXIT TUNES PRESENTS Entrance Dream Music - 
chameleon - nana (Sevencolors) feat. Hatsune Miku (初音ミク Sweet) - Sevencolors Works 2010 - 2011 - 
39 Music! (39みゅーじっく!) - Mikito-P (みきとP) feat. Hatsune Miku (初音ミク) - 初音ミク 「マジカルミライ 2016」 OFFICIAL ALBUM - 
Next Nest (ネクストネスト) - Hatsune Miku (初音ミク) feat. Satsuki ga Tenkomori (さつき が てんこもり) - マジカルミライ 2014 OFFICIAL ALBUM - 
Shinkai Shoujo (深海少女) (Chorus) (6 people) - Nico Nico Chorus (合唱) - 
無炎舞踊≠循環 - EastNewSound - Split Theory - 
S.A.T.O.R.A.R.E - Halozy - Future Love - 
宝相華 - C-CLAYS - 
Dreamin' - Irus - M4D ESSENCE - 
アモリタチテカミトミユ - Syrufit - Where is Love - 
Spring Lane ~ Rest In Peace, Saith The Lord. (春色小径 ~ Rest In Peace, Saith The Lord.) - Demetori (東方アレンジ) - Determinism&DestruKction - 
Sadistic Paranoia - EastNewSound - Split Theory - 
とびだせ!バンキッキ - Shibayan Records - RETRO FUTURE GIRLS - 
緋色月下、狂咲ノ絶　(1st Anniversary Remix) - EastNewSound - Sacred Factor - 
Haitoku no Tsubomi (背徳の蕾 ) - IOSYS - キュートでアグレッシヴ☆幻想郷レボリューション - 
ダブルラリアット - アゴアニキ feat. 巡音ルカ - EXIT TUNES PRESENTS Megurhythm - 
End of Daylight - Alstroemeria Records - genealogy | shrinemaiden - 
Black Butterfly - EastNewSound - Lucent Wish - 
If you're my destiny, end this fated determination - TUMENECO - 
Myosotis alpestris - Syrufit - Love Hearts? - 
Monochrome in the Night (モノクロ・インザナイト) - Shibayan Records - Adrastea - 
Monochrome in the Night (モノクロ・インザナイト) (CYTOKINE remix) - Shibayan Records - Sedecim - 
Ten Desires. - Syrufit / Poplica* - love - 
Steady night - EastNewSound - Dione Aggregation - 
シークレットシスターコンプレックス - Halozy - Halozy Best Vol.1 - 
From the Deep Sea With Love (深海より愛を込めて) - Senya - 
Black Lotus - EastNewSound - Lucent Wish - 
萃夢想歌 - Silver Forest - Silver Forest 2006-2012 BEST1 - 
命の降る郷 - Liz Triangle - 
Gohatto Disco (さつき_が_てんこもり) - Hatsune Miku / Snow Miku (雪ミク) - 
君が望んだ永遠 - Silver Forest - Silver Forest 2006-2012 BEST1 - 
恋のセレナーデ - Halozy - Tonic Triangle - 
COLORFUL BOX - 石田燿子 - COLORFUL BOX / Animetic Love Letter - 
宝箱-TREASURE BOX- - 奥井雅美 - 宝箱-TREASURE BOX- / プラチナジェット - 
ｼｬﾊﾞﾄﾞｩﾋﾞﾀｯﾁﾍﾝｼｰﾝ - ｹﾞﾘﾗ的 - 
Sweet Devil (歌ってみた) (Reol (れをる) feat. Kradness) - Hachioji-P (八王子P)/8#Prince feat. Hatsune Miku (初音ミク) -  - 
Streaming Heart (ストリーミングハート) - Reol (れをる) - Upload feat.Vocalist - 
Systematic Love (システマティック・ラヴ) - Reol (れをる) - 
いけないBorder & Funky - fazerock - 
wanna go to a beach! VS. Resort Sunset - Camellia (かめりあ) - Camellia "Guest Tracks" Summary & VIPs 01 - 
MEGANTO METEOR - Camellia (かめりあ) - MEGANTO METEOR - 
KISEKAE (android52 edit) - android52 - android52 presents WELCOME NEW GALAXY - 
Soba ga Tabetai (そばが食べたい) - Mikeneko Homeless (三毛猫ホームレス) - インターネット e.p. - 
.Lilium.(Full.Version) - Elfen.Lied. - 
Yukitoki Chameleon (Oblongar Mashup) - Nagi Yanagi and Hatsune Miku - 
Future Cαndy (Braven Remix) - YUC'e (ゆーしえ) - 
Future Cαndy (i5cream Remix) - YUC'e (ゆーしえ) - 
Future Cαndy (RomTimney Remix) - YUC'e (ゆーしえ) - 
Mischievous Function (おちゃめ機能) - Lon (ろん) - 
Ubawaretamono (ウバワレタモノ) - sasakure.UK feat. lasah - 不謌思戯モノユカシー - 
N (エヌ) - Kurage-P (くらげP) feat. Kagamine Rin (鏡音リン) - 
Love Me If You Can (ヲタみん Cover) - Megurine Luka (巡音ルカ), IA (イア), Kagamine Rin (鏡音リン), GUMI (グミ), and Hatsune Miku (初音ミク) - 
Date Time （デートTIME) - Mineral Miracle Muse (ミネラル★ミラクル★ミューズ) - デートTIME - 
ラヴコリーダ - シシド・カフカ - カフカナイズ - 
フェスで踊っているときに流れている曲 - スネ夫が - 
Donut Hole (ドーナツホール) (鎖那 Cover) - GUMI - 
Click (Asteriks Remix) - ClariS - 
HIBANA (ヒバナ) (柘榴 Cover) - DECO*27 feat. Hatsune Miku (初音ミク) - 
Beast Dance (ビースト・ダンス) - Kurage-P (くらげP) feat. 音街ウナ - 
Lost in the Waves - Yoshimasa Hosoya - 
フェスタ・イルミ*ーション × G*40 (mashup) - KyotoSketch  - 
Blue Bird (ブルーバード)  - Lon (ろん) - 
Pomeguraneito (ポメグラネイト ここなつ) - Hinabita / Coconut (ひなビタ /ここなつ) - シンクロノーツ - 
Fun Tonight - マクロスMACROSS 82-99 - CHAM! - 
5 Hyoshi / go byôshi (5拍子) - Midori (ミドリ) - Aratamemashite, Hajimemashite, Midori Desu - 
Love Doll (ラブドール) (そらる Cover) - DECO*27 - 
Love Me If You Can - Megurine Luka (巡音ルカ), IA (イア), Kagamine Rin (鏡音リン), GUMI (グミ), and Hatsune Miku (初音ミク) - 
I Miss You - マクロスMACROSS 82-99 with ローマンRoman - CHAM! - 
ワールズエンド・ダンスホール (ROCKETMAN remix) - wowaka feat. 初音ミク・巡音ルカ - 初音ミク DANCE REMIX vol.1 - 
Soba ga Tabetai (そばが食べたい) - Mikeneko Homeless (三毛猫ホームレス) feat. Nagi Nemoto (根本凪) - 
ペパーミント脱走計画 - Mikeneko Homeless (三毛猫ホームレス) x happy machine feat. Nagi Nemoto (根本凪) - 
Furu Biyori (ふゆびより) - Eri Sasaki (佐々木恵梨) - ふゆびより - 
Kimagure Mercy (気まぐれメルシィ) - Hachioji-P (八王子P) feat. Hatsune Miku (初音ミク) - Eight -THE BEST OF 八王子P- - 
Sweet Devil (八王子P VDM Remix) - Hachioji-P (八王子P)/8#Prince feat. Hatsune Miku (初音ミク) - Desktop Cinderella - 
Carry Me Off - Hachioji-P (八王子P) feat. Hatsune Miku (初音ミク) - Twinkle World - 
Twinkle World - Hachioji-P (八王子P) feat. Hatsune Miku (初音ミク) - Twinkle World - 
SeventH-HeaveN - sasakure.UK feat. Hatsune Miku (初音ミク) - 幻実アイソーポス - 
Party Junkie (Colate Remix) - Hatsune Miku (初音ミク) - 
Repairers of the Deceptive World (Kagaribito) (カガリビト) - Hatsune Miku (初音ミク) - 
ぶれないアイで - Mitchie M feat. 初音ミク - 39D - 
Setsuna ni Chiroutomo (刹那に散ろうとも) - Silver Forest - Rebirth - 
Zenzenzense (Movie Version) (Many Previous Existences) (前前前世) - RADWIMPS - Your Name - 
談感情 (官方版MV) - Jeno Liu (劉力揚) - 
千本桜 - 和楽器バンド - ボカロ三昧 - 
Solar System Disco (太陽系デスコ 歌った) (ARAKI (あらき)×nqrse Cover) - NayutalieN - 
Tenstions (曖) (feat. ØZI) - Shi Shi (孫盛希) feat. ØZI - Shi's Journey (希遊記) - 
Mirror - Yasuda Rei (安田レイ) - Mirror - 
The Picture In My Heart (心中的圖畫) - Men Envy Children (小男孩樂團) - 
MR.TAXI (Dance ver.) (Music Video) [Japanese ver.] - Girls' Generation (소녀시대) (少女時代) - THE BEST - 
Surrounded by Enemies (Shimensoka) (四面楚歌) - Megurine Luka (巡音ルカ), IA (イア), Kagamine Rin (鏡音リン), GUMI (グミ), and Hatsune Miku (初音ミク) - 
The B♥chy Idol - Luo Tianyi (洛天依) - 
JINGO JUNGLE - MYTH & ROID - JINGO JUNGLE - 
The Moon Represents My Heart (月亮代表我的心) - Teresa Teng (鄧麗君) - 難忘的Teresa Teng - 
If I Were Young (年少有為) - Ronghao Li (李榮浩) - 耳朵 - 
MyonMyonMyonMyonMyonMyonMyon! - Shibayan Records - RETRO FUTURE GIRLS - 
Desert Years - Shibayan Records - RETRO FUTURE GIRLS - 
MyonMyonMyonMyonMyonMyon! - 3L - ムソウマテリアライズ - 
invitation - Kou Shibasaki (柴咲コウ) - 嬉々♥ - 
Mukei Spirit (無形スピリット) Mugen Loop Remix (TeddyLoid Remix) - Kou Shibasaki (柴咲コウ) - 無形スピリット - 
NEXT STAY (DJ Noriken Remix) - Minamotoya (源屋) - 
Dancing Whitebait - 源屋 - Bright Colors 3 - 
Last Night - 源屋 feat. motoko - Bright Colors - 
Moonlight (feat. 袁婭維) - Will Pan (潘瑋柏) feat. Tia Ray (袁娅维) - Moonlight - 
Moonlight (feat. 袁婭維) [中文版] - Will Pan (潘瑋柏) feat. Tia Ray (袁娅维) - Moonlight - 
犬Kあ3L - 澤野弘之 - KILL la KILL ORIGINAL SOUND TRACK - 
劈你的雷正在路上 - Cyndi Wang (王心凌) - CYNDILOVES2SING 爱。心凌 - 
Those Bygone Years (那些年) - Hu Xia (胡夏) - 燃點 - 
デモムービー - 花の野に咲くうたかたの  - 
Life Sucks (消極掰) - Jolin Tsai (蔡依林) - Ugly Beauty - 
Honey Moon Un Deux Trois (蜜月アン・ドゥ・トロワ) (Kurokumo (くろくも or 黒雲) Cover) - DATEKEN feat. Kagamine Rin (鏡音リン) - 
Sakasama Bridge (逆様ブリッジ) - Suneohair (スネオヘアー) - 逆様ブリッジ - 
Honey Moon Un Deux Trois (蜜月アン・ドゥ・トロワ) (Rina (里奈) Cover) - DATEKEN feat. Kagamine Rin (鏡音リン) - 
HUSTLE - Tifa Chen (陈梓童) - HUSTLE - 
鬼龍G@キLL - 澤野弘之 - BEST OF SOUNDTRACK【emU】 - 
Sparkle (Movie Version) (Supākuru) (スパークル) - RADWIMPS - Your Name - 
Karma - Dareharu - Karma - 
Gee - Girls` Generation(소녀시대) - Gee - 
Sting (찔려) - Stellar (스텔라) - 찔려 - 
ct16041 + ct16031 - KIRARA (키라라) - 
Comes And Goes (와리가리) - Hyukoh (혁오) - 22 - 
Neurotic - Boygem - 
恢复 - 2814 - 新しい日の誕生 - 
The Refrain of the Lovely Great War - Jun.A - 
AiAe - DJ'TEKINA//SOMETHING - 
+♂ - Reol (れをる) - 
Digital Kecak No.5 (Remo-Con Remix Radio Edit) - DJ TECHNORCH - 円 - 
Die - Jeff Williams and Casey Lee Williams - RWBY: Volume 2 Soundtrack - 
Flying - ill.Gates and Stephan Jacobs feat. Jackie Rain - Terminally Ill - 
Dream Come True - Jeff Williams and Casey Lee Williams - RWBY: Volume 2 Soundtrack - 
Caffeine - Jeff Williams and Casey Lee Williams (feat. Lamar Hall) - RWBY: Volume 2 Soundtrack - 
All Our Days - Jeff Williams and Casey Lee Williams - RWBY: Volume 2 Soundtrack - 

I Burn - Jeff Williams (feat. Casey Lee Williams & Lamar Hall) - RWBY: Volume 1 Soundtrack - 
I May Fall - Jeff Williams feat. Casey Lee Williams - RWBY Volume 1 Soundtrack - 
Sacrifice - Jeff Williams and Casey Lee Williams - RWBY: Volume 2 Soundtrack - 
Red Like Roses - Part II - Jeff Williams (feat. Casey Lee Williams & Sandy Casey) - RWBY: Volume 1 Soundtrack - 
This Will Be the Day (Acoustic) - Jeff Williams and Casey Lee Williams - RWBY: Volume 2 Soundtrack - 
Time to Say Goodbye (James Landino's Beach Bae Remix) - Jeff Williams and Casey Lee Williams - RWBY: Volume 2 Soundtrack - 
Wings - Jeff Williams (feat. Casey Lee Williams) - RWBY: Volume 1 Soundtrack - 
some other time - Yoko Kanno - Ghost in the Shell STAND ALONE COMPLEX CD-BOX - 
monochrome - Ilaria Graziano - Ghost in the Shell STAND ALONE COMPLEX CD-BOX - 
Ikazuchi - Saradisk - 
Fallen Angel / [unknown] - Mitsunori Ikeda feat. Aimee B / [unknown] - Panty & Stocking with Garterbelt: The Original Soundtrack - 
Happy Life (ハッピーライフ) - nicamoq (にかもきゅ) - はいぱぁ電波これくしょん! ファンタスティック★大和編 - 
California Love - 2Pac - 2Pac Special - 
2 HAL 9000 - sasakure.UK feat. lasah - INNOCENCE - 
Fake Ass Bitches (OG) - 2Pac - R U Still Down? [Remember Me] - 
Die Die Die! - Widdly 2 Diddly - LISA Soundtrack - 
Moonsetter - Toby "Radiation" Fox feat. Samm Neiland & Clark Powell - Homestuck, Volume 9 - 
where does this ocean go? - Ilaria Graziano - Ghost in the Shell STAND ALONE COMPLEX CD-BOX - 
Sweet Devil - Hachioji-P/8#Prince feat. Hatsune Miku (初音ミク) - 初音ミク-Project DIVA- Ƒ Complete Collection - 
velveteen - Ilaria Graziano - Ghost in the Shell STAND ALONE COMPLEX CD-BOX - 
A Cruel Angel's Thesis (残酷な天使のテーゼ) 2009 VERSION - Yoko Takahashi (高橋洋子) - 残酷な天使のテーゼ 2009 VERSION - 
Definition of a Rap Flow - A-F-R-O - Definition of a Rap Flow - 
Take on Me - a-ha - 101 80s Hits - 
Dancin' (Krono extended mix) - Aaron Smith feat. Luvli - Chilled House, Session 7 - 
I Don't Trust You - Abitan - HARD STATION COMPILATION SEASON 1 - 
Acid Rain - Lorn - The Maze to Nowhere, Part 2 - 
Boop - Jeff Williams and Casey Lee Williams - RWBY: Volume 2 Soundtrack - 
20 Percent Cooler - Alex S. - Emotions of Note - 
Thunderstruck - AC/DC - AC/DC Gold 2000 - 
Aero Dynamik - Kraftwerk - Wipeout Pulse - 
Highway to Hell - AC/DC - Greatest Hits: Platinum Collection '2003 - 
Aests - fight - 
Koi Wa Shita No Wa (恋をしたのは) - aiko - 恋をしたのは - 
銀河鉄道のペンギン (Stripe.P Remix) - Aiobahn & Yunomi feat. nicamoq - 
Impulse - Aesthetik - 
Towa no Utage (永久の宴) - Aiobahn w/ YUC'e (ゆーしえ) - Märchen EP - 
Alone in Kyoto - Air - Lost in Translation: Music From the Motion Picture Soundtrack - 
Parfait - Aire - POPOVER+TEATIME 3 - 
エアーマンが倒せない - Team.ねこかん[猫] - CDで聞いてみて。〜ニコニコ動画せれくちょん〜 - 
あいぞめ - 能登麻美子 - 地獄少女 二籠 オリジナルサウンドトラック - 
Ai Ai Ai ni Utarete Bye Bye Bye - Flow - 
Dårhus / När solen går ner - Aki feat. Kapten Röd - När solen går ner - 
海色(みいろ)  - AKINO from bless4 - 海色 - 
Don't Matter - Akon - Radio 538 Hitzone 42 - 
Alone - Alan Walker - Alone - 

Destination Calabria - Alex Gaudino feat. Crystal Waters - Destination Calabria - 
Party With Pinkie (The Living Tombstone's Remix) - Alex S. - 
Lollipop (Param Pam Pam) - Alexandra Stan - Saxobeats (deluxe edition) - 
Mr. Saxobeat - Alexandra Stan - Mr. Saxobeat - 
KawaiiStep - Alex Skrindo and Geoxor - 
Poison - Alice Cooper - No More Mr Nice Guy Live - 
U Don't Know (Just a Gent Remix) - Alison Wonderland feat. Wayne Coyne - U Don't Know - 
U Don't Know - Alison Wonderland feat. Wayne Coyne - U Don't Know - 
Allowance - Doll.ia - 
秘蜜 ~黒の誓い~ - ひとしずくP feat. 鏡音リン・鏡音レン - EXIT TUNES PRESENTS Vocalonexus - 
I'm In Control (SAINT WKND Remix) - Aluna George - 
Zombie Killer - Amsterdam Station - 
Yours Truly, - Andrew Luce - 
super anime groove 3d world - android52 - android52 presents WELCOME NEW GALAXY - 
Stardust - android52 - 52 days of autumn - 
Animal Parade - MUST DIE! - Never Say Die, Volume 4 - 
Smooth Criminal (live in Denver) - Alien Ant Farm - Up in the Attic - 
Dia - Anji - Dia - 
Remember Summer Days (マクロスMACROSS 82-99 Bootleg) - Anri - 
Distant - ANTI-HERO and Atura - 
Distant (Sekai Remix) - ANTI-HERO and Atura - 
artcore JINJA - An - 
Boom Shack-a-lack - Apache Indian - One World - 
Alberto Balsalm (33RPM - 66% Speed) - Aphex Twin - 
Flim (33RPM - 66% Speed) - Aphex Twin - 
Girl/Boy Song (33.3 rpm) Slowed Down - Aphex Twin - 
Distant Horizon - aran feat. Kanae Asaba - ARCHVS - 
Fragment Of Crystal - aran - Round Up Crystals EP - 
GRiDGALAXY - aran - ARCHVS - 
Hyperdawn - aran - TRI▼FORCE - 
Anima Libera (Strong Edit) - Emi - 
Moonbound - aran feat. yukacco - α [alpha] - 
KALACAKLA - aran & lapix - ARCHVS - 
Brianstorm - Arctic Monkeys - Brianstorm - 
Ripples (DJ Noriken Remix) - aran - Unitone PHASE: Remixes - 
R U Mine? - Arctic Monkeys - Gilmore Girls: The Ultimate Soundtrack, Volume 3 - 
Arctic Monkeys Vs Dr Dre & Eminem (Curtis Jones Mashup) - Arctic Monkeys, Dr Dre, and Eminem - 
Everyday - Ariana Grande feat. Future - Dangerous Woman - 
Evoke - ARSNL - 
Maybe - Aṣa - Beautiful Imperfection - 
Preacher Man - Aṣa - Beautiful Imperfection - 
Nanatsu Issensakura - A.saka - 
Kyoto - aso. - 
Seasons (Multi Remix) - Aso - 
Boo Hoo [Remastered] - Assertive Fluttershy - Theory of Pony - 
Boooring! - Assertive Fluttershy - 100% No Feeble Cheering - 
Around the World (La La La La La) - ATC - Around the World (La La La La La) - 
Bat Country - Avenged Sevenfold - All Excess - 
Hey Brother - Avicii - Now That's What I Call Running 2014 - 
Levels - Avicii - Joey Essex Presents Essex Anthems - 
Silhouettes - Avicii - F*** Me I'm Famous! Ibiza Mix 2012 - 
I Could Be the One - Nicktim - Avicii vs. Nicky Romero - Fun Radio: Summer Dance 2013 - 
Beautiful Lies VIP - B-Complex - Hospitality Drum & Bass 2010 - 
Crying Soul (DJ Splash Remix) - B0UNC3 - Single - 
Megitsune - BABYMETAL - Here's the Metal: July 2015 - 
Akatsuki (紅月アカツキ) - BABYMETAL - Live at Budokan - 
Ijime, Dame, Zettai (イジメ、ダメ、ゼッタイ) - BABYMETAL - BABYMETAL - 
Gimme Chocolate!! (ギミチョコ!!) - BABYMETAL - BABYMETAL - 
Doki Doki ☆ Morning (ド・キ・ド・キ☆モーニング) - BABYMETAL - BABYMETAL - 
Bad Apple!! - Alstroemeria Records feat. nomico - Lovelight - 
Bad Luck Charm - Jeff Williams - RWBY: Volume 4 Soundtrack - 
Kaleidoscope (Kaytranada's Flip) - BADBADNOTGOOD - 
Title Theme / Saria's Song / Song of Storms - BADBADNOTGOOD - BBNG - 
Bad Apple!! (Lizz English Cover) - Alstroemeria Records - 
Guns at Dawn - Baron feat. Pendulum - Guns at Dawn / Ratpack - 
Never Say Never - Basement Jaxx feat. ETML - Junto - 
Good Luck - Basement Jaxx feat. Lisa Kekaula - Good Luck - 
Good Luck - Basement Jaxx feat. Lisa Kekaula - Kish Kash - 
Vi sitter i Ventrilo och spelar DotA - Basshunter - LOL <(^^,)> - 
Bass Slut - S3RL - 
All I Ever Wanted (Radio Edit) - Basshunter - All I Ever Wanted - 
Now You're Gone - Basshunter feat. DJ Mental Theo's Bazzheadz - Now You're Gone: The Album - 
Mama (Мама) - Basta (Баста) - Баста I - 
Again and Again - Basto! - NRJ Hit Music Only! 2012 - 
Beautiful Lies ( DnB Step ) (Remix) - B-Complex - 
BEAUTIFUL WORLD - Kikuo (きくお) feat. lasah - INNOCENCE - 
Cinema - Benny Benassi feat. Gary Go - 
Zombie - Besomorph and N3WPORT feat. Whoshafee - 
Better Off Alone (radio edit) - Alice DeeJay - Better Off Alone - 
Betty Boop - Harald Kindseth - 
Bombs Over Brooklyn - Big Data - 1.0 - 
Clean - Big Data feat. Jamie Lidell - 2.0 - 
Dangerous - Big Data feat. Joywave - 1.0 - 
Bimpé - Aṣa - Beautiful Imperfection - 
Bingo - André van Duin - De Amstel Boyz Presenteren - 
スターゲイザー (DJ Sharpmarker Remix) - DJ Noriken feat. YUC'e (ゆーしえ) - スターゲイザー feat.YUC'e -『ストラとスフィア』OPテーマ- - 
Boom - BL3R - 
Dawn of a Dark Day - Black Sun Empire feat. Foreign Beggars - From the Shadows - 
SO HOT (THEBLACKLABEL remix) - BLACKPINK - SO HOT (THEBLACKLABEL remix) - 
BLACK or WHITE? - BlackYooh vs. siromaru - KERBEROX - 
Hyperspark - BlackY - Hyperspark - 
Satisfaction - Benny Benassi presents The Biz - Absolute Dance: Move Your Body, Volume 2 - 
Where Is Home (Burial remix) - Bloc Party - Ministry of Sound: The Sound of Dubstep - 
The Bad Touch - Bloodhound Gang - Absolute Music 23 - 
Knockin' on Heaven's Door - Bob Dylan - Music & Words 1998 to 1963 - 
BoJack's Theme - Patrick Carney feat. Ralph Carney - BoJack's Theme - 
Freestyler - Bomfunk MC's - Global Hits 2002 - 
Mandarine Girl - Booka Shade - Mandarine EP - 
Born to be - nano (ナノ) - Born to be - 
Break Ya Self (Wipeout mix) - B Phreak & Groove Allegiance - Wipeout Pulse - 
Play with it (Gigi B Mix) - Breakdown feat. Whiskey Pete Julz - 
Breakfast in America - Supertramp - Millennium Gold - 
"Toxic" The Video - Britney Spears - In the Zone - 
Unclesam Goddamn - Brother Ali - Vice CD, Volume 14: Number 4 - 
Reality - Bro Safari feat. Sarah Hudson - 
Do Re Mi - Budi - 
Tuesday (Radio Edit) - Burak Yeter feat. Danelle Sandoval - Tuesday - 
Butterfly (Aki Remix) - Smile - Smile - 
Butterfly (Upswing mix) - SMiLE.dk - Smile Paradise - 
Atrévete, Te, Te - Calle 13 - Superventas 2007 - 
Summer - Calvin Harris - We Love Summer 2014 - 
I Need Your Love - Calvin Harris feat. Ellie Goulding - Joey Essex Presents Essex Anthems - 
Dance on the Mars - Camellia (かめりあ) - dreamless wanderer - 
dreamless wanderer - Camellia (かめりあ) - dreamless wanderer - 
δ:for the DELTA - Camellia (かめりあ) - PLANET//SHAPER - 
Coliseum - Campo - 
Can You Feel the Love Tonight - Elton John - Love Songs - 
Mighty & High - Can't Stop Won't Stop - 
Up and Away - Can't Stop Won't Stop feat. June - Up and Away - 
Hello (The Hair Kid Remix) - Capsule - 
Dream a Dream - Captain Jack - 
Late Night Kouhai (Sushi Killer Remix) - Capturelight - 
Shimakaze - Capturelight & Zenpaku - 
Human Leather Shoes for Crocodile Dandies - Caravan Palace - <|°_°|> - 
The Rhythm Of The Night - Cascada - 
Castle in the Sky - DJ Satomi - 100% Números uno - 
Centuries vs Animals (Mashup) - Fall Out Boy and Maroon 5 - 
Centuries/Animals Mashup - Fall Out Boy and Maroon 5 - 
The Writer - Chance The Rapper - 
Opus One - Chamberlain x Kindred - 
Boom Clap - Charli XCX - The Voice Hits, Volume 1 - 
Amirah - Chasing Shadows - Ministry of Sound: The Sound of Dubstep - 
Love Is Over - chelmico - chelmico - 
Chemical - Move-Ya! & Steve Lavers - Wipeout Pulse - 
Cherry Pop - S3RL feat. Gl!tch - 
Opposite of Adults - Chiddy Bang - Bravo Black Hits, Volume 23 - 
Underwater - Voltz - We Are Magunoria Vol. 2 - 
China Dress - Memme - 
Chinese Restaurant - Memme - 
CHOCOLAT - TCY FORCE feat. Mariya Ise - Panty & Stocking with Garterbelt: The Original Soundtrack - 
Do I Wanna Know? (CHVRCHES Cover) - Arctic Monkeys - 
City Lights (Martin Buttrich remix, PSP cut) - Loco Dice - Wipeout Pulse - 
Rather Be - Clean Bandit feat. Jess Glynne - New Eyes - 
Close Your Eyes - Relect - Close your eyes - 
THE BADDEST FEMALE (나쁜 기집애) - CL - 나쁜 기집애 - 
Pandora - Code Black - Qlimax: Immortal Essence - 
Your Moment (Remastered Edit) - Code Black & Wasted Penguinz - 
Mosaic Kakera (モザイクカケラ) - SunSet Swish - モザイクカケラ - 
Spongebob - Coki - Ministry of Sound: The Sound of Dubstep 3 - 
Bendera (New Version) - Cokelat - Untukmu INDONESIA-ku - 
Over U - Cola Splash & Gersonik - 
Onyx - CoLD SToRAGE - Wipeout Pure - 
Paradise - Coldplay - Radio 538 Hitzone 60 - 
Cold - Jeff Williams feat. Casey Lee Williams - RWBY: Volume 3 Soundtrack - 
Chillin' It - Cole Swindwell - 
A Real Hero - College feat. Electric Youth - 
Trumpsta - Contiez feat. Treyy G - Absolute Music 73 - 
Fool's Paradise - Don McLean - Platinum - The Ultimate Collection - 
Rhythm of the Night - DeBarge - Smash Hits Party - 
Crimson Belvedere ~ Eastern Dream - Demetori - Like Facing the Abyss ~ Willow Hazes in Spring Rain - 
Bad Apple!! (Cristina Vee English Cover) - Alstroemeria Records - 
Boxer (original mix) - Crookers - From Then Until Now - 
Trapped (Hi-tack radio mix) - Peter Gelderblom vs. Dan Parker - Club Base 2008.1 - 
Crystal Sky - S3RL feat. Sara - 
I Walk Alone (Commercial Club Crew Remix Edit) - Crystal Lake vs Commercial Club Crew - 
I Walk Alone (Radio Edit) - Crystal Lake vs Commercial Club Crew - 
Next Planet - Cubicolor - 
cyberbird - Gabriela Robin - Ghost in the Shell STAND ALONE COMPLEX CD-BOX - 
Daddy DJ - Daddy DJ - Global Hits 2002 - 
Gasolina - Daddy Yankee - 
Around the World - Daft Punk - Best of 538 Dance Smash Summer Edition - 
Derezzed - Daft Punk - TRON: Legacy - 
Digital Love - Daft Punk - Got Dance? - 
Get Lucky (radio edit) - Daft Punk feat. Pharrell Williams - Get Lucky - 
Harder, Better, Faster, Stronger - Daft Punk - Musique, Volume 1: 1993-2005 - 
Instant Crush - Daft Punk feat. Julian Casablancas - 
Lose Yourself to Dance - Daft Punk - 
Television Rules the Nation / Crescendolls - Daft Punk - Alive 2007 / Alive 1997 - 
Around the World / Harder Better Faster Stronger - Daft Punk - Alive 2007 / Alive 1997 - 
Never Rains (M&Ace Remix) - Dance R Us - 
Never Rains (Radio Edit) - Dance R Us - 
Never Rains (X-Cess! Remix) - Dance R Us - 
Gubben i lådan - Daniel Adams-Ray - 
打上花火 - DAOKO x 米津玄師 - 打上花火 - 
BLISS - dark cat and jHacs - 
Sandstorm - Darude - The Biggest Breakdowns of All Time - 
Don't Sing (feat. Benny Sings) - DatA feat. Benny Sings - Don't Sing - 
デート・ア・ライブ - sweet ARMS - 劇場版デート・ア・ライブ 万由里ジャッジメント ORIGINAL SOUNDTRACK - 
Deja Vu - Dave Rodgers - Super Eurobeat Presents Initial D Super Euro Best - 
Night Fever - Dave Rodgers & Mega NRG Man - SUPER EUROBEAT presents INITIAL D 〜D SELECTION 2〜 - 
Love is Gone - David Guetta and Chris Willis - Pop Life - 
Baby When the Light - David Guetta feat. Cozi - Pop Life - 
Titanium - David Guetta(feat) Rob Swire - 40 Years of Disruptions - 
Ascension - David Eman - 
Play Hard - David Guetta feat. Ne-Yo & Akon - Play Hard - 
Sexy Bitch - David Guetta feat. Akon - The Best Of - 
Day After Day - Millennium - Pioneer: The Album, Volume 7 - 
I'm Not Alone - D.Baola - 
Flying High - DC-10 (DCX) - 
Deadly Premonition (Whistle Theme) - 
I Remember (original mix) - Kaskade & deadmau5 - I Remember - 
Raise Your Weapon (Madeon remix) - deadmau5 - Raise Your Weapon (Remixes) - 
Raise Your Weapon - deadmau5 - 4×4=12 - 
The Veldt - deadmau5 feat. Chris James - The Veldt EP - 
Waters - Debris and Clarx - 
HIBANA (ヒバナ) - DECO*27 feat. Hatsune Miku (初音ミク) - HATSUNE MIKU 10th Anniversary Album 「Re:Start」 - 
Reversible Campaign (リバーシブル・キャンペーン) - DECO*27 - GHOST - 
Streaming Heart (ストリーミングハート) - DECO*27 feat. Hatsune Miku (初音ミク ) - EXIT TUNES PRESENTS Vocalofantasy - 
Heart a la mode - DECO*27 feat. Hatsune Miku and 初音ミク - 
Love Doll - DECO*27 feat. GUMI - 
HOME - DECO*27 x 40mP feat. Hatsune Miku - 
Deep Sea Girl - Hatsune Miku - 
Deep Sea Girl (深海少女) (Piano Ver.) (Lizz Robinett English Cover) - Hatsune Miku (初音ミク) - 
Bubbletop (DF's Bubble Wrapped Mix) - Dennis Ferrer feat. Sagine - 

The Boy Who Murdered Love - Diana Vickers - Songs From the Tainted Cherry Tree - 
Til Death (Technoposse Remix) - Til Death - Til Death - 
Til Death (Technoposse Remix Edit) - Til Death - Til Death - 
Make It Real - Dirty Stab - 
Disconnected - Helblinde - 
Tricky Disco - Discotronic - 
Divide - Jeff Williams feat. Casey Lee Williams - RWBY: Volume 3 Soundtrack - 
United State of Pop 2014 (Do What You Wanna Do) - DJ Earworm - United State of Pop 2014 (Do What You Wanna Do) - 
DMC WORLD CHAMPION 2013 - DJ FLY - 
Earthquake instrumental - DJ Fresh - 
Flashlight - DJ Fresh feat. Ellie Goulding - The Biggest Breakdowns of All Time - 
'Louder' - DJ Fresh feat. Sian Evans - 
Hot Right Now - DJ Fresh feat. Rita Ora - The Biggest Breakdowns of All Time - 
Dear You - DJ Genericname - 
All the things she said (Radio Mix) - DJ Gollum feat. Scarlet - 
Exceeder - Dj Mason - 
Break Away - DJ Noriken - #HYPRFLVX - 
Coming True - DJ Noriken - シンシサクラク・エンハンサー - 
Kaguratsuki - DJ Noriken - #HYPERFLVX - 
Daybreak - DJ Noriken - Driven' De:st-ructure 2  - 
Bluebird Story (feat. Jumelles) - DJ Okawari - Diorama - 
Represent - DJ Okawari feat. 金原千恵子 - Kaleidoscope - 
I Remember - Dj Passion - 
Anima Libera - DJ Raaban - 
Be Alive! - Nightcore - Dreamworld - 
Drop The Base - Dj Raaban - 
Addict - S3RL - 
Baby Baby - S3RL - 
Crank It Louder - S3RL - 
S.L.U.T Hardcore - S3RL - 
Take Me - S3RL - Make You Move / Take Me / You'll Never - 
Waves (Danny R. Radio Edit) - DJ Satomi - 
Waves - DJ Satomi - 100% Números uno - 
Moving Shadow - DJ Shimamura feat. Yukacco - MAX - 
Magik Night - DJ Shimamura feat. Yukacco - Alkanet - 
Like A Rainbow Feat. Yukacco - DJ Shimamura - Elektronix - 
Open Your Heart - DJ Shimamura x Mitomoro feat. Lindsey Marie  - ORTHODOX - 
Turn Down For What (MO BUTT PROPANE REMIX) - DJ Snake - 
Flying High (DJ Splash Remix) - DC-10 (DCX) -  - 
DJ Whore - S3RL feat. Tamika - 
Burning Me - DJ Noriken - #HYPRFLVX - 
Call to Me - DJ Noriken - SKETCH BOOK! Anthology 3 - 
Enjoy This Time - DJ Noriken feat. yukacco - #From_Ten_Wonderland - 
#Magicalgirl_Syndrome - DJ Noriken - HAPPYNATION #03 - 
Matilda - DJ Noriken - METAMORPHOSE - 
See The Lights - DJ Noriken - 明星デストピア - 
Summerlights - DJ Noriken - EDP presents ravemania speed - 
Taurus - DJ Noriken - 
Midnight Train - DJ OKAWARI feat. Emi Meyer - Compass - 
Bad Chick - DJ Shimamura - Lilium X3 - 
BIG BOOBS INSANITY (Buchiage Jungle Terror Mix) - DJ Shimamura - JP-H/D #6 - 
Raver's In The Sky (Exclusive Summer Remix) - DJ Shimamura - 
Starlight (Could You Be Mine) (Colin McLoughlin Remix) - Don Diablo & Matt Nash - Starlight (Could You Be Mine) (Remixes) - 
On My Mind - Don Diablo - 
Starlight (Could You Be Mine) (extended) - Don Diablo & Matt Nash - Starlight (Could You Be Mine) (Remixes) - 
Don't You Worry Child - Swedish House Mafia - I Love Verano 2013 - 
Danza Kuduro (DJ EBo Remix) - Don Omar feat. Lucenzo, Daddy Yankee, Akon, and Pitbull - 
Whatever Will Be, Will Be (Que Será, Será) - Doris Day - Eis am Stiel, Volume 8 - 
Madernach Fik Laaib (الدوزي - ما درناش فيك العيب) - Douzi - My Life - 
Nuthin But a 'G' Thang Uncut & Dirty - Dr. Dre feat. Snoop Dogg - 
The Wash - Dr. Dre & Snoop Dogg - "The Wash" Original Motion Picture Soundtrack - 
The Mission - Dread Pitt and Yung Fusion - 
Take You Back VIP - Vaizo feat. Pandub - 
Future Cαndy (iMeiden Remix) - YUC'e (ゆーしえ) - 
Moskau - Dschinghis Khan - 40 Jahre ZDF-Hitparade - 
Recalled to Life - Dutch Master - Hardstyle Attack 2010 - 
Recalled to Life - Dutch Master - Explosive Car Tuning 22 - 
Cool Kids - Echosmith - Acoustic Dreams - 
Cool Kids vs Kids - Echosmith vs MGMT - 
Annul - 0edit - Neotokyo GSDF - 
Stereo Love - Edward Maya feat. Vika Jigulina - Top Chart - 
Stereo Love - Edward Maya&Vika Jigulina - Best of 2010 - Die Zweite - 
Shape of You (J.Fla Cover) - Ed Sheeran - 
All Alone With You - EGOIST - All Alone With You - 
Blue (Da Ba Dee) - Eiffel 65 - Fired Up! - 
Move Your Body - Eiffel 65 - 
Sugar Rush (Centron Remix) - Virtual Riot - 
Wave - Eli Way - 
Lights (single version) - Ellie Goulding - Lights - 
Lights (Shook remix) - Ellie Goulding - Lights - 
Uy Uy Uy - Compass feat. Carlos Ann and Kool A.D. - 
Mr.Blue Sky - ELO - 
De guerre lasse - Elyose - Ispo Facto - 
Fractal - Elyria feat. Danyka Nadeau - 
Anima Libera (Sweet Edit) - Emi - 
Energetic Techno Core (Royalty Free Music - Audiojungle Preview) - Flutist - 
Masked bitcH (colate remix) - Giga-P (ギガP)×おればなな feat. GUMI - 
Honey Moon Un Deux Trois (蜜月アン・ドゥ・トロワ) (Lucy English Cover) - DATEKEN feat. Kagamine Rin (鏡音リン) - 
Septette for the Dead Princess (亡き王女の為のセプテット) - ZUN - 東方紅魔郷 ~ Embodiment of Scarlet Devil. - 
Call on me (HD) - Eric Prydz - 
Pjanoo (club mix) - Eric Prydz - Promo Only: Mainstream Club, October 2008 - 
Emerlad Red (2012) - Erick Upheaval - 
os-宇宙人 (Asterisk Makina Remix) - Asterisk - Asterisk Works 3 - 
American Boy - Estelle feat. Kanye West - Shine - 
日本式硬核-OukaRanman- - ETIA. - 
Discord - The Living Tombstone - Emotions of Note - 
Sweet Dreams (Are Made of This) - Eurythmics - Sweet Dreams (Are Made of This) - 
Everyday - Buddy Holly - Yesterdays Gold: 120 Golden Oldies, Volume 1 - 
쉐이크 (Shake)! - E.via - Must Have - 
Dance, Dance But It's Let's Get It Started by The Black Eyed Peas (William Maranci Mashup) - Fall Out Boy and The Black Eyed Peas - 
Thnks fr th Mmrs - Fall Out Boy - Alternative Times, Volume 81 - 
Don't Speak - Far East Movement feat. Tiffany (티파니) of 소녀시대, King Chain - IDENTITY - 
Like a G6 - Far East Movement feat. The Cataracs & Dev - Like a G6 - 
Freal Luv - Far East Movement, Marshmello feat. 찬열 of EXO, Tinashe - IDENTITY - 
Feel Good in Black and Yellow - Wiz Khalifa and Gorillaz feat. De La Soul - Black and Yellow - Single - 
Feel The Melody - S3RL feat. Sara - 
Horizons - Feint feat. Veela - 
Reprise - Feint - 
Pure Imagination - Fiona Apple - Pure Imagination - 
Lost in Thoughts All Alone (English Version) (AmaLee Cover) - AmaLee - 
Lost in Thoughts All Alone (English Version) - Rena Strober - 
Lost in Thoughts All Alone (if〜ひとり思う〜) - Renka (蓮花) - if〜ひとり思う〜 - 
Lost in the Waves (English Version) - Matthew Mercer and Rena Strober - 
End of All (Land) (すべての路の果てに~地) (English Version) - 森下弘生 - ファイアーエムブレム if ORIGINAL SOUNDTRACK - 
ABZ Asian BoyZ - Sicco Blue - 
Lost in Thoughts All Alone (Shigure's Version) (English Version) - Matthew Mercer - 
End of All (Sky) (すべての路の果てに~天) (English Version) - 森下弘生 - ファイアーエムブレム if ORIGINAL SOUNDTRACK - 
Lost in Thoughts All Alone (Shigure's Version) - Yoshimasa Hosoya - 
ENISHI ~For Sakura and Elise~ - Hiroki Morishita (森下弘生) - ファイアーエムブレム if ORIGINAL SOUNDTRACK - 
Little Lies - Fleetwood Mac - Tango in the Night - 
Crave You (Adventure Club Dubstep Remix) - Flight Facilities feat. Giselle - Crave You (Adventure Club Dubstep Remix) - 
Crave You - Flight Facilities feat. Giselle - Nova Tunes 2.3 - 
Flat Out - Dopamine - Wipeout Pulse - 
Right Round - Flo Rida feat. Ke$ha - Right Round - 
Whistle - Flo Rida - Now That's What I Call Running 2014 - 
This Is How We Roll - Florida Georgia Line feat. Luke Bryan - 
She Is A Maniac - Flashdance - 
DAYS - Flow - DAYS - 
Whistle (Newklear Re-Boot Extended) - Flo Rida - 

Believe Me - Fort Minor - Now Autumn 2006 - 
Pumped Up Kicks (original version) - Foster the People - Pumped Up Kicks: Remixes - 
Don't Stop (TheFatRat remix) - Foster the People - Don't Stop Remix - 
Memory (radio mix) - Fragma - Dance Nation 2009 - 
Evil Eye - Franz Ferdinand - Live EP - 
Love Illumination - Franz Ferdinand - Right Action / Love Illumination - 
No You Girls - Franz Ferdinand - So Fresh: The Hits of Winter 2009 - 
Just Freakin' - Freakadelika - Club Rotation, Volume 38 - 
Take Me Out - Franz Ferdinand - Triple J: Hottest 100 of All Time - 
Frontline - Ed Rush, Optical & Matrix - Wipeout Pulse - 
From Shadows - Jeff Williams (feat. Casey Lee Williams) - RWBY: Volume 1 Soundtrack - 
Blue Bird (ブルーバード) - ikimonogakari (いきものがかり) - ブルーバード - 
MTBD (멘붕) - CL - CRUSH - 
Memory (Rob Mayth Remix) - Fragma - 
Blush (Moe Shop Remix) - Fusq feat. MYLK - 
Perfume! x Superstar - Fusq and Moe Shop feat. Hentai Dude - Owarini Tokyo Liveshow - 
Overclock - Fusk Asker - 
OUTRO. 신곡 (神曲) (Divina Commedia) - G-Dragon - 권지용 - 
ambiguous - GARNiDELiA - Linkage Ring - 
Kuusou Mesorogiwi (ENGLISH) - AmaLee and NateWantsToBattle - 
Pure Imagination - Leslie Bricusse & Anthony Newley - Willy Wonka & the Chocolate Factory - 
Genre Police - S3Rl feat. Lexi - 
奇跡の薔薇 - Galla - INITIAL D BEST SONG COLLECTION 1998-2004 - 
Estonia: Rockefeller Street - Getter Jaani - Eurovision Song Contest: Düsseldorf 2011 - 
Nightfall - Getty - Krazy Psycho Bass 2 - 
(Feel Like) Jam - Getty - A/LOG:02 - 
Bad Monkey - Getty - HARDCORE HONORS - 
Growler - Getty - J-NERATION 7 - 
Paradox - Getty - Five-Star Luster - 
thrace - Gabriela Robin - Ghost in the Shell STAND ALONE COMPLEX CD-BOX - 
Bla Bla Bla - Gigi D'Agostino - Viva Hits 8 - 
Swagger - Gingy - Wipeout HD Fury - 
Pacific Coast Highway - Ghasper - 
Dawn of Asia (ginkiha mix) - ginkiha - 
Like The Sand - G.I.T - 
GIVE UP - i am robot and proud feat. lasah - "I LOVE YOU," - 
furioso melodia - gmtn. (witch's slave) - 
Crazy - Gnarls Barkley - Black Summer Party: Best Of, Volume 5 - 
Brynhildr in the Darkness -Ver. EJECTED - Nao Tokisawa - 
All Day Mashup Let It Out (New Remix Song) - Girl Talk - 
Going On - Gnarls Barkley - 2009 GRAMMY Nominees - 
Gold - Jeff Williams (feat. Casey Lee Williams) - RWBY: Volume 1 Soundtrack - 
本当の言葉 - FOOT STAMP - Japan Is Punk as Fuck - 
gonna rice - Yoko Kanno - Ghost in the Shell STAND ALONE COMPLEX CD-BOX - 
DARE (video) - Gorillaz - DARE - 
Stylo - Gorillaz - Plastic Beach - 
Somebody That I Used to Know - Gotye feat. Kimbra - More Music 2012 - 
Feel Good Inc - Gorillaz - Feel Good Inc - 
One Night in Arabia - Go Go Girls - SUPER EUROBEAT presents INITIAL D 〜D SELECTION 3〜 - 
Sigmund (The Requiems Extended MIX) - Gram (DJ Genki) - The Requiem - 
ARCADIA - Gram (DJ Genki) - The Requiem - 
Hit That Jive - Gramatik - Street Bangerz Vol. 2 - 
Weapon - Grant feat. Baum - Rocket League x Monstercat Vol. 1 - 
Emiya (エミヤ) (guitar version)  - CROW'SCLAW - 十七分割 - 
Yggdrasil - Gram (DJ Genki) vs Kobaryo - The Requiem - 
Boulevard of Broken Dreams - Green Day - American Idiot - 
Touch me - greyl - RE PAK 4 - 
Hit or Miss - greyl - RE PAK 4 - 
Anaconda / Grisaiaconda (Triple-Q Mashup Remix) - Nicki Minaj - 
Invisible - GUMI & Rin - 
I want (Я хочу) - GRIVINA - Я хочу - 
Masked bitcH - Giga-P (ギガP)×おればなな feat. GUMI - ぎがばなな ざ べすと 〜USUSHIO味〜 - 
Paradise City - Guns N' Roses - 1992-12-05: Night of the Livid Red Head: Estadio River Plate, Buenos Aires, Argentina - 
Masked bitcH (Satsuki ga Tenkomori/Club Remix) - Giga-P (ギガP)×おればなな feat. GUMI - 
Infinity 2008 (Klaas remix) - Guru Josh Project - Ministry of Sound: Addicted to Bass 2009 - 
Stereo Hearts - Gym Class Heroes feat. Adam Levine - 
Sand Planet (砂の惑星) - Hachi feat. Hatsune Miku (初音ミク) - 
What Is Love - Haddaway - The Best of Dance Non Stop Mix - 
Just Jammin' - Gramatik - Street Bangerz Vol. 2 - 
Out of Touch - Hall & Oates - Veronica Top 1000 Allertijden: Editie 2008 - 
Poltergeist (Nightcore) - Zatox feat. Nikkita - 
Tip Taps Tip - HALCALI - Tip Taps Tip - 
Alien Alien (エイリアンエイリアン) (Nhato Remix) - NayutalieN (ナユタン星人) - EXIT TUNES PRESENTS Entrance Dream Music3 - 
Spaceman - Hardwell - Spaceman - 
源流懐古 - Halozy - Halozy Best Vol.1 - 
Harumodoki / 春擬き(Asterisk DnB Remix) - Nagi Yanagi - 
DAS GEHT BOOM (SHAG RAGGA!) - Harris & Ford vs. Gordon & Doyle feat. Lisah - 
Harumodoki - Nagi Yanagi - 
シンフォニック・ラブ - 橋本みゆき - ましろ色シンフォニー -Love is pure white- Sound Track - 
Arcadia (radio edit) - Hardwell & Joey Dale feat. Luciana - Fun Dancefloor Winter 2015 - 
Hatsune Miku - Personality Complex (ペルソナリティ・コンプレックス) - Hatsune Miku - 
Love Philosophia (恋愛フィロソフィア) - Kurousa-P (黒うさP) feat. Hatsune Miku (初音ミク) - 5th ANNIVERSARY BEST - 
Rubik's Cube - Hatsune Miku - 
Rolling Girl - Hatsune Miku (初音ミク) - 
This Fucked-Up Wonderful World Exists For Me (このふざけた素晴らしき世界は、僕の為にある) - n.k feat. Hatsune Miku (初音ミク) - 
World is Mine (AshZone Remix) - Hatsune Miku - 
Chameleon Love (カメレオン・ラブ) - Hatsune Miku - 
Earthquake (Fytch Remix) - Little Boots - 
Addicted (Revised Version) - Circus-P - FIVE - 
Never Rains ✮ (Nightcore) - Dance R Us - 
Fabulous Secret Powers!! - He-Man - 
Wanna - KARA (카라) - Revolution - 
maldades - Hector El Father - 
Grief & Malice - Helblinde - 
Imagine Breaker - Helblinde - 
Ritsuen!! (トランペットブラック者) - Helblinde - Untitled Album - 
Are You Ready For The Fluor - Helmuth - 
Here Comes the Hotstepper (Evian version) (Yuksek remix) - Baby & Me - Fun Radio: Dancefloor Anthology - 
X / Love - Hex Cougar x Zack Gray - 
HIBIKASE (ヒビカセ) - Reol (れをる) - 
Aston Martin - Higher Brothers feat. Ken Rebel - Black Cab - 
寄明月 - SING女團 - 
Love is War - Helblinde - 
WeChat - Higher Brothers feat. Keith Ape - Black Cab - 
Fake - HIGHSOCIETY feat. Amy Kirkpatrick - 
Made in China - Higher Brothers feat. Famous Dex - Black Cab - 
『かなしみアップデイト』  - HINTO - 
Work It Out - Higher Self & Tom Budin feat. SWEEDiSH - 
Bring Me Back - High N' Rich - 
promise - 広瀬香美 - タイアップコレクション〜広瀬香美のテレビで聴いたあの曲達〜 - 
Lost in Thoughts All Alone  (if〜ひとり思う〜) (Blue Forest Version) - Renka (蓮花) - if〜ひとり思う〜 - 
Home - Jeff Williams feat. Casey Lee Williams - RWBY: Volume 4 Soundtrack - 
Shonen Heart - Home Made Kazoku - 
Irony (アイロニ) - majiko (まじ娘) - Contrast - 
masterpiece - Hommarju feat. Latte - EXIT TRANCE PRESENTS SPEED アニメトランス BEST 7 - 
『シーズナル』  - HINTO - 
Flashes (Extended) - Dollscythe - beatmania IIDX 22 PENDUAL ORIGINAL SOUNDTRACK VOL.2 - 
Honey Moon Un Deux Trois (蜜月アン・ドゥ・トロワ) - DATEKEN feat. Kagamine Rin (鏡音リン) - 
Follow Me Blind (Radio Edit) [Full Version] - Honka - 
Follow Me Blind - Honka - 
Hands Up - Hommarju - WAVES - 
Dust - M|O|O|N - Hotline Miami 2: Wrong Number - 
Hotline Spikes (Death Grips X Hotline Miami Mashup) (Sewerslvt Mashup) - Jasper Byrne and Death Grips - 
How I Want Ya - J-Man feat. Lara Wilson - 
Natsuzora - ナツゾラ - HoneyComeBear - 
Plastiktüte - Husky - Riverside POP Free - 
Quake Howling - hurce - Krazy Psycho Bass 2 - 
City Lights - HyperJuice feat. EVO+, Jinmenusagi - 
City Lights (Pa's Lam System Remix) - HyperJuice feat. EVO+, Jinmenusagi - 
City Lights (Zekk Remix) - HyperJuice feat. EVO+, Jinmenusagi - 
City Lights (Tomggg "Sunday Candy" Remix) - HyperJuice feat. EVO+, Jinmenusagi - 
GIRL - HyperJuice feat. Jinmenusagi - 
Miami - Jasper Byrne - Hotline Miami EP - 
I Ship It - Icona Pop - 
I&U - 安田レイ - パスコード4854 - 
Konoha's State of The World - Hatsune Miku & IA - Blindfold City Days - 
Somebody Else - hvdson - 
It Was a Good Day - Ice Cube - R&B SummerJamz - 
Mastication numérique - Igorrr - Poisson soluble - 
Make a Move - Icon for Hire - Christian Rock Hits X 2012 - 
Peanut Choker - Iglooghost - Little Grids - 
Fractures - Illenium feat. Nevve - Fractures Ft. Nevve - 
Flying (Anarky Remix) - ill.Gates and Stephan Jacobs feat. Jackie Rain - 
Clouds - Imagined Herbal Flows - 
Radioactive - Imagine Dragons - iTunes Session - 
I'm the One - Jeff Williams feat. Casey Lee Williams - RWBY: Volume 3 Soundtrack - 
I Won't Fall Apart - Jager - Super Eurobeat, Volume 204 - 
Won't You Stay - Indivision & Livewire feat. Tasha Baxter - 
Burning up for You (Extended Mix) - Sara - Eurobeat Masters, Volume 2 - 
Night & Day - Mr. Groove - SUPER EUROBEAT presents INITIAL D 〜D SELECTION 3〜 - 
Wings of Fire - Mako & Sayuki - SUPER EUROBEAT presents INITIAL D 〜D SELECTION 2〜 - 
Love & Money (extended mix) - Za-Za - Eurobeat Masters, Volume 1 - 
Dance Around the World - Delta Queens - SUPER EUROBEAT PRESENTS INITIAL D D SELECTION - 
Don't Stand So Close - Dr. Love - SUPER EUROBEAT presents INITIAL D 〜D SELECTION 2〜 - 
If I Didn't Care - Ink Spots - 
inner universe - ORIGA - Ghost in the Shell STAND ALONE COMPLEX CD-BOX - 
Border of extacy - IOSYS - 東方真華神祭 - 
Spheres - ilan Bluestone - 
Run to the Hills (video) - Iron Maiden - The Number of the Beast - 
Nonstop Pop 2015 Mashup  New and beautiful - Isosine - 
Cluster A (Fusq Remix) - in the blue shirt - 
Sekali Lagi (from "Critical Eleven") - Isyana Sarasvati - Paradox - 
Kau Adalah - Isyana Sarasvati feat. Rayi Putra - Explore! - 
My Life Is a Party (radio edit) - ItaloBrothers - The Dome, Volume 63 - 
Nonstop Pop 2014 Mashup - Isosine - 
Evacuate the Dancefloor - Cascada - Miss Independent: From the Ladies of Pop - 
In My Mind (Axwell radio edit) - Ivan Gough, Axwell, Feenixpawl & Georgi Kay - Absolute Workout - 
Cloud 9 - Itro & Tobu - 
Wild Growth - IVV - POPOVER+TEATIME 3 - 
i do - Ilaria Graziano - Ghost in the Shell STAND ALONE COMPLEX CD-BOX - 
Candy Princess - Freezer feat.妃苺 - J-NERATION 6 - 
It's My Turn - Jeff Williams feat. Casey Lee Williams - RWBY: Volume 3 Soundtrack - 
Take Ü There (Baile Funk Remix) - Jack Ü feat. Kiesza - 
FIRE - J Spiff - 
Take Ü There - Jack Ü feat. Kiesza - Skrillex and Diplo Present Jack Ü - 
Ghost Town - Josh A & iAmJakeHill - Chaos - 
How I Want Ya - J-Man feat. Lara Wilson - 
Endless Nightmare - Jake Hill and Josh A - 
Peeping Tom - Jamie Berry feat. Rosie Harte - Peeping Tom - 
Talk Dirty - Jason Derulo feat. 2 Chainz - The Dome, Volume 68 - 
Whatcha Say - Jason Derülo - Radio 538 Hitzone 53 - 
Hood Gone Love It - Jay Rock feat. Kendrick Lamar - Follow Me Home - 
Dirt Off Your Shoulder (Smle Jupe Remix) - Jay Z - 
Honey Moon Un Deux Trois (蜜月アン・ドゥ・トロワ) (じろ Cover) - DATEKEN feat. Kagamine Rin (鏡音リン) - 
Escape - USAO - Kick's For Liberation 2 - 
Bambino - Jean Dujardin - Hits & Dance: Summer 2006 - 
Shining In The Dark - JEDDI feat. Chuck New - 
Wanderlust - Jelle Slump feat. Aidan O'Brien - 
It's Amazing - Jem - 
Silent Moon - Jia Peng Fang (賈鵬芳) - Pacific Moon - 
Voodoo Child ( Slight Return ) - Jimi Hendrix - 
Love is a Miracle - Jinco feat. SVNAH - Love is a Miracle - 
JINGO JUNGLE -HBB Remix- - MYTH & ROID - eYe's - 
Maximum Overload - Jinpachi Futushimo - 
Make A Move On Me - Joey Negro - 
il vento d'oro  (Golden Wind) - Yugo Kanno - JOJO's Bizarre Adventure Golden Wind O.S.T vol.1 Overture - 
Dere Dere - Josip On Deck - 
さよならは笑顔で (fu mou Remix) - Joy Time People - 
D.A.N.C.E. (MSTRKRFT remix) - Justice - D.A.N.C.E. (Remixes Extended) - 
D.A.N.C.E. (live at Inrocks Festival) - Justice - ✝ - 
Stay - Jakoban and D!avolo feat. Gaby Henshaw - 
DVNO (radio edit) - Justice - DVNO - 
Phantom Pt. II (Soulwax Remix) - Justice - 
Phantom, Part II (Boys Noize remix) - Justice - Phantom, Part II - 
Electrode - K-391 - K-391 Tracks of 2012 - 
Just Girly Things Remix - Dawin feat. Kalin and Myles - 
Tsubasa wo Kudasai (翼をください) - 桜高軽音部 - ふわふわ時間 - 
feel good - jåmvvis - celebration  - 
The Lost One's Weeping (ロストワンの号哭) - Neru feat. Kagamine Rin (鏡音リン) - 世界征服 - 
Suki Kirai (スキキライ) - HoneyWorks feat. Kagamine Rin (鏡音リン), Kagamine Len (鏡音レン) - マジカルミライ 2014 OFFICIAL ALBUM - 
Cold Inflation (Extend Mix) - kanone vs. Yooh - Energy Of The Moon - 
ギガンティックO.T.N - ギガP×おればなな feat. 鏡音レン - ぎがばなな ざ べすと 〜USUSHIO味〜 - 
Flashing Lights - Kanye West feat. Dwele - 
Can't Tell Me Nothing - Kanye West - Now That's What I Call Music! 26 - 
Good Life - Kanye West feat. T-Pain - Graduation - 
Wolves - Kanye West feat. Vic Mensa & Sia - The Life of Pablo - 
</emotional> - kamome sano - Lilium X2 - 
Tidal - Karaplex and Finder - 
Cycle Hit (サイクルヒット) - KASAI HARCORES (葛西ハーコーズ) - 葛西ハーコーズ EP2 オールスターズ - 
Karinui - Noto Mamiko - 
1234567890 (Titancube Remix) - KATOMORI - 
Dark Horse - Katy Perry feat. Juicy J - We Love Summer 2014 - 
Chained to the Rhythm - Katy Perry feat. Skip Marley - Witness - 
Nightcall - Kavinsky - Electro Shock - 
One Day (Vandaag) - Bakermat - We Love Summer 2014 - 
Kawaii Fashion 2016 - Mikeneko Homeless (三毛猫ホームレス) feat. Onomatope Daijin (オノマトペ大臣) - 
STEP - KARA (카라) - BEST GIRLS - 
Die Young - Ke$ha - Fun Radio: Summer Dance 2013 - 
Absolute Territory (Remix) - Ken Ashcorp - 
Take It Off - Ke$ha - Animal - 
Paralyzed (Mystery Skulls cover) - Ken Ashcorp - 
Danger Zone - Kenny Loggins - Best of the 80s - 
Let Me Show You - Kero One & Azure - Kero & Azure - 
Pursuit of Happiness (Nightmare) - Kid Cudi feat. MGMT & Ratatat - Man on the Moon: The End of Day - 
TiK ToK - Ke$ha - Animal - 
Day 'n' Nite - Kid Cudi vs. Crookers - Ministry of Sound: One R&B - 
Gomen ne, Iiko ja Irarenai. (ごめんね、いいコじゃいられない。) - Sawai Miku - 
Before My Body is Dry - Mika Kobayashi - 
R.I.P. - Kero One feat. Suhn - Color Theory - 
Till I Die - CASG - 
鬼龍G@キLL - 澤野弘之 - BEST OF SOUNDTRACK【emU】 - 
Blumenkranz - 澤野弘之 - KILL la KILL ORIGINAL SOUND TRACK - 
I want to know [lyrics] - Benjamin Anderson - 
All the Way - Mikuni Shimokawa (下川みくに) - all the way - 
The Beautiful World - 前田愛 - The Beautiful World - 
Rainbow Tylenol - Kitsune2 - Squaredance - 
Rock My Emotions - Kitsune2 - Squaredance - 
Make It High - KO3 & Relect - Bright Colors 4 - 
Get Down (Srav3R Remix) - Getty - Kirara Trails - 
Let's Get Fxxked - KO3 vs Getty - 幻奏ドリームランド - 
Speed Complexxx - Kobaryo feat. Srezcat - MIXPEED ACTION - 
Robot Love - Klaypex ft. GRÉTA - 
lit (var) - Kensuke Ushio (牛尾憲輔) - A Silent Voice (Koe no Katachi) Original Soundtrack (映画 聲の形 オリジナル・サウンドトラック) a shape of light - 
Mosaic - KOAN Sound x Culprate x Asa x Sorrow - 
The Rolling - kors k vs Camellia - S2TB Files7: Battle Royale - 
lots of love - KOTONOHOUSE feat.kotono - POPOVER+TEATIME 3 - 
Sora - 下村陽子 - KINGDOM HEARTS Original Soundtrack COMPLETE - 
Mukei Spirit (DJ AMAYA vs DJ USYN REMIX) - Kou Shibasaki (柴咲コウ) - 
Rain - Motohiro Hata (秦基博) - 言ノ葉 - 
Burn for You (The Cop 4 club mix) - Kreo' - Burn for You - 
New World - Krewella & Yellow Claw feat. Taylor Bennett - New World, Part 2 - 
Alibi - Krewella - Alibi - 
pray - KOTONOHOUSE feat. Such - Such - innocent - 
Calm Down - Krewella - New World, Part 1 - 
Calm Down (Chime and Halcyon Remix) - Krewella - 
New World - Krewella & Yellow Claw feat. Vava - 
Burn for You - Kreo' - Burn for You - 
Can't Get You Out of My Head - Kylie Minogue - Party: The Collection - 
Timeless - K A R M A - 
Earthquake - Labrinth feat. Tinie Tempah - Ministry of Sound: One R&B - 
Pokerface (live at the Cherrytree House piano & voice version) - Lady Gaga - Disco Heaven: The Fame B=2.0 - 
Firestone - Kygo - Clubland 28 - 
Telephone - Lady Gaga feat. Beyoncé - The Fame Monster - 
君が泣くなら - Lamp - 
I Won't Work (やだ働かない)  - Lamaze-P feat. Hatsune Miku - 
Summertime Sadness (Cedric Gervais remix) - Lana Del Rey - Future Trance, Volume 64 - 
PsyStyle Nation - lapix & Massive New Krew - PsyStyle Nation - 
Big Ride - Lary and His Flask - 
Just Dance - Lady Gaga feat. Colby O'Donis - The Fame - 
Repairers of the Deceptive World (Kagaribito) (カガリビト) (lasah Cover) (English Ver) - Hatsune Miku (初音ミク) - 
Summertime Sadness (Reich & Bleich Remix) - Lana Del Rey - 
INNOCENCE - Yasunori Mitsuda (光田康典) feat. lasah - INNOCENCE - 
Blue Shift - Lemaitre - Relativity 1 - 
Stairway to Heaven - Led Zeppelin - Hiawatha Express - 
Excuse Me - Lemaitre - The Kitsuné Special Edition #2 (Kitsuné Maison 12 + Gildas Kitsuné Club Night Mix #2) - 
START - Leftymonster -  - 
Wait (Elephante remix) - Lemaitre feat. LOLO - Singularity (remixed) - 
Remember Me (Extended Mix) - Leslie Parrish - Super Eurobeat, Volume 99 - 
Wait - Lemaitre feat. LOLO - Singularity - 
Let's Just Live - Jeff Williams feat. Casey Lee Williams - RWBY: Volume 4 Soundtrack - 
Slow Down (WRLD Remix) - LIGHTS - 
lifecouldbeadream - Future James - 
Like Morning Follows Night - Jeff Williams feat. Casey Lee Williams and Lamar Hall - RWBY: Volume 4 Soundtrack - 
$ave Dat Money - Lil Dicky feat. Fetty Wap and Rich Homie Quan - 
Get Low - Lil Jon & The East Side Boyz feat. Ying Yang Twins - Promo Only: Mainstream Radio, August 2003 - 
Ex-Boyfriend - Lil Dicky - So Hard - 
Thrifty (mashup) - Lil Dicky and Macklemore  - 
Prayer in C (Robin Schulz remix) - Lilly Wood & The Prick - Fun Radio: Dancefloor Anthology - 
Prayer in C (Robin Schulz remix) - Lilly Wood & The Prick and Robin Schulz - Prayer in C - 
Work Harder - Widdly 2 Diddly - LISA Soundtrack - 
Still Alive (Mirrors Edge OST) - Lisa Miskovsky - 
All Eyes On Us - Lenno and Jack Novak feat. Racella - 
Crack Traxxxx (Exxxxtend Mixxxx) - Lite Show Magic - We are "Lite Show Magic" - 
666 Kill Chop Deluxe - Widdly 2 Diddly - Lisa The Joyful Soundtrack  - 
Little Apple - Chopsticks Brothers - 
Stronghold - Lite Show Magic - Raise Blaze in Fiction - 
Redial - livetune feat. 初音ミク - 
Every Little Earthquake - Little Boots - 
living inside the shell - Steve Conte - Ghost in the Shell STAND ALONE COMPLEX CD-BOX - 
Vapor (Dustkey Remix) - Lockyn - 
Crack traxxxx - Lite Show Magic - 
Lollipop - The Chordettes - Yesterdays Gold: 120 Golden Oldies, Volume 1 - 
Vamos a la playa - Loona - Ballermann Hits 2010 - 
Lost In Thoughts All Alone (English Version) (Adriana Figueroa Cover) - Adriana Figueroa - 
Lost In Thoughts All Alone (English Version) (Lizz Robinett Version) - Lizz Robinett feat. Dysergy - 
JOY - Lon (ろん) - 
How Low - Ludacris - Battle of the Sexes (iTunes CountDown) - 
Love is in Danger (Extended Mix) - Priscilla - Eurobeat Masters, Volume 2 - 
Dancing Wildly (狂喜乱舞) - Megurine Luka, Hatsune Miku, and GUMI - 
Danza kuduro - Lucenzo feat. Don Omar - Emigrante del mundo - 
Watermelon - lulu + Mikeneko Homeless - This Christmas Lovely Day - 
Despacito - Luis Fonsi feat. Daddy Yankee - Despacito - 
LUVORATORRRRRY! - Reol (れをる) feat.nqrse - 
One Look - LVTHER feat. Mammals - Monstercat - Best of 2014 - 
Asagao - lulu + Mikeneko Homeless - 
'Paris' [Hotline Miami Soundtrack] - M.O.O.N. - 
Magnolia (VIP) - M2U feat. Guriri (グリリ) - Magnolia - 
Weapon (Live Launchpad Mashup) - M4SONIC - 
The Queen - M2U - Owarini Tokyo Liveshow  - 
Do It 4 U - Machinedrum feat. D∆WN - Human Energy - 
Thrift Shop - Macklemore & Ryan Lewis feat. Wanz - Thrift Shop - 
Can't Hold Us - Macklemore & Ryan Lewis feat. Ray Dalton - 538 Hitzone: Best of 2013 - 
Finale - Madeon feat. Nicholas Petricca - Adventure - 
Mad World - Gary Jules - KFOG: Live From The Archives 11 - 
'Hydrogen' [Hotline Miami Soundtrack] - M.O.O.N. - 
Pay No Mind - Madeon feat. Passion Pit - Adventure - 
Hung Up - Madonna - Celebration: The Video Collection - 
Ghost Assasin (Hourglass Bonusmix) - Maduk feat. Veela - 
MAGICAL✰GIRL - Sushi Killer - 
Rude - MAGIC! - The Voice Hits, Volume 1 - 
Lean on - Major Lazer feat. MØ & DJ Snake - Absolute Summer Hits 2015 - 
Pop Culture - Madeon - Pop Culture - 
Wild Fire - MandoPony and Silva Hound - 
Just Another Night (Anthem 4) - Manian & Floorfilla - Energy NRJ: Hit Music Only! Best of 2013, Volume 2 - 
Gas Gas Gas - Manuel - Super Eurobeat Presents Initial D Fifth Stage D Selection - 
Mind Brand (マインドブランド) - Maretu feat. Hatsune Miku (初音ミク) - コインロッカーベイビー - 
Digital Love - Mardial feat. Ramengvrl - Mardial & Friends - 
Mendekat, Melihat, Mendengar - Maliq & Dessential - 
You Reposted in the Wrong Neighborhood Extended - ＳＨＯＫＫ青 - 
Sexual Healing (Kygo Remix) - Marvin Gaye - 
Animals vs Centuries - Maroon 5 x Fall Out Boy - 
Mr. Almost (差不多先生) - MC HotDog (熱狗) - Mr. Almost - 
Medusa (Медуза) - MATRANG - ЭЙА - 
Shinespark (Evan King Orchestral Remix) - MDK - 
The Sound - Mayhem - Eggs and Other Songs - 
ME!ME!ME! - TeddyLoid feat. daoko - 
Meet Her At The Love Parade - Superstar DJs - 
Monster (DotEXE Dubstep Remix) - Meg & Dia - Mein Leben - 
Monster - Meg & Dia - Vans Warped Tour: 2007 Tour Compilation - 
Leave The Lights On - Meiko - 
Leave The Lights On (Krot Remix) - Meiko - 
Leave The Lights On (Stoto Remix) - Meiko - 
The Weekend - Michael Gray - Ultimate FloorFillers 2000-2010 - 
GIRL - Daoko - 
Walk It Talk It - Migos feat. Drake - Culture II - 
City Down Under (M83 vs Men At Work mashup) - Mighty Mike - 
Moonlight Shadow - Mike Oldfield - Media Markt Collection: The 80s, Volume 2 - 
Purity - Mikeneko Homeless (三毛猫ホームレス) feat. Nagi Nemoto (根本凪) - 
Kawaii Fashion - Mikeneko Homeless (三毛猫ホームレス) feat. Onomatope Daijin (オノマトペ大臣) - インターネット e.p. - 
Soba ga Tabetai (そばが食べたい) (MMQX Remix) - Mikeneko Homeless - 
America - Mikeneko Homeless (三毛猫ホームレス) x Masayoshi Iimori feat. Nagi Nemoto (根本凪) - 
Miku - Anamanaguchi feat. Hatsune Miku - Miku - 
Mastodon (Louis The Child Remix) - Milk N Cookies ft. Alina Renae - 
Stolen Dance - Milky Chance - The Dome, Volume 68 - 
One - Metallica - The Videos: 1989-2004 - 
lights by my side - DJ Noriken - Visio Nocturna - 
Mirror Mirror (White Trailer) - Jeff Williams (feat. Casey Lee Williams) - RWBY: Volume 1 Soundtrack - 
Only You - Misael Gauna & Evence - 
Mind-Blowing SIX Song Country Mashup! - 
Mirror Mirror Part II - Jeff Williams feat. Casey Lee Williams - RWBY: Volume 3 Soundtrack - 
ビバハピ - Mitchie M feat. 初音ミク - グレイテスト・アイドル - 
Arcadia Bae - Mitomoro - FÜGENE - 
Misleading Title - S3RL feat. DEFI BRILATOR - 
Apropos - Mittsies - Helltaker Soundtrack - 
Misery In A Bottle (Beaver's MashUps Mashup) - Christina Aguilera and Paramore - 
Epitomize (VIP Edit) - Mittsies - Epitomize (VIP Edit) - 
Epitomize (Sinner's VIP) - Mittsies - Epitomize (Sinner's VIP) - 
Luminescent - Mittsies - Helltaker Soundtrack - 
Vitality (VIP edit) - Mittsies - Helltaker Soundtrack - 
Vitality - Mittsies - Helltaker Soundtrack - 
Epitomize - Mittsies - Helltaker Soundtrack - 
Dameyo (ダメよ♡) - Mizca - ダメよ♡ - 
Here for You - Kygo feat. Ella Henderson - Now That's What I Call Music! 92 - 
Lady (Hear Me Tonight) - Modjo - Ministry of Sound: Chilled House Classics - 
Moestep - Moe Shop - 
Want You - Moe Shop - Want You - 
Superstar - Moe Shop feat. Hentai Dude - Moshi Moshi - 
Optinuum (original mix) - Moguai - Optinuum (original mix) - 
Alive - Mondotek - 
Good Place - Mondgomery - 
All Is Hell That Ends Well - Two Steps From Hell - SkyWorld - 
The Prophecy - Tony Anderson feat. Aubrey Prunty - Movements of the Heart - 
Daughter of The Flame / Epic Hybrid Trailer - Audiopizza - 
Pastel - Moe Shop and Snail's House  - 
God Mode - Sons of Amon - 
Too Young to Fall in Love - Mötley Crüe - Shout at the Devil - 
Bust the Future Wall (remixed by DJ VISAGE) - m.o.v.e - INITIAL D BEST SONG COLLECTION 1998-2004 - 
Rays of Dawn - MoonShard - 
around the world - m.o.v.e - electrock - 
BREAK IN2 THE NITE - m.o.v.e - INITIAL D BEST SONG COLLECTION 1998-2004 - 
ROCK IT DOWN (Radio edit) - m.o.v.e - REWIND 〜singles collection+〜 - 
over drive - m.o.v.e - INITIAL D BEST SONG COLLECTION 1998-2004 - 

Rage your dream - m.o.v.e - electrock - 
Motownphilly (remix radio edit) - Boyz II Men & Michael Bivins - Cooleyhighharmony - 
Sierra Leone - Mt Eden - Dubstep/DnB Collection - 
Coco Jambo - Mr. President - All Stars Disco 9 & 10 - 
MTC2 - S3RL feat. SONiKA - 
Heartbreaker (feat. John Legend) - MSTRKRFT - Heartbreaker - 
MTC - S3RL - Super Fun Happy Time - 
無形スピリット - 柴咲コウ - CIRCLE CYCLE - 
Ring (su na Remix) - mus.hiba X su na - 
Pass the Dutchie - Musical Youth - The Best of the Eighties: Forty Tracks, Original Hits - 
Beautiful Girl - MVZR - 
[A]ddiction - EVO+ feat. Reol (れをる) x GigaP (ギガP) - EVOLUTION - 
Into My Arms - Mylo - 
Pyrotechniqué - Mullaha - 
I NEED U - BTS(방탄소년단) - 화양연화 pt.1 - 
Mythologia's End - Hatsune Miku - 
Hellbent - Mystery Skulls feat. SnowBlood - Forever - 
雪を聴く夜 - MYTH & ROID - eYe's - 
Frozen Rain - MYTH & ROID - JINGO JUNGLE - 
-to the future days - MYTH & ROID - eYe's - 
Tough & Alone - MYTH & ROID - eYe's - 
My Hardcore - RoughSketch Feat. DD"ナカタ"Metal - The Far East Hard Session - 
Tsukihana - Nana Kitade - 
TRY UNITE! (aran Remix) - Nakajima Megumi - 
Meikaruza (instrumental) - Nanahoshi Kangengakudan - 
Nasty - S3RL & 5H4RK80Y ft Thylie - 
Heartbeat - Nathalie - SUPER EUROBEAT PRESENTS INITIAL D D SELECTION - 
夏祭り - 鬱P、ミナツキトーカ feat. 初音ミク - どう考えても私は悪くない - 
Zenophile - Mylo - Trax #02 - 
Riders on the Storm (Fredwreck feat. Snoop Dogg remix) - The Doors - The Doors Remixed - 
A Cruel Angel Thesis (Director's Edit Version) - Yoko Takahashi - Neon Genesis Evangelion Soundtrack 1 - 
Neon - Jeff Williams feat. Casey Lee Williams - RWBY: Volume 3 Soundtrack - 
Hegira - necchi feat. Such - Such - innocent - 
Free WiFi - NeoTune and TobiMorrow - 
Neko Nation Anthem (S3RL remix) - Noc.V - 
Toulouse (Wumbaloo Remix) - Nicky Romero - 
Call From Babylon - Nick Skitz and Technoposse - Future Trance 69 - 
NEVER RAINS (Lowcash Remix) - Dance R Us - 
Hold Me Back - Nicko Mills and Max Fail - 
ナイト・オブ・ナイツ - COOL&CREATE - 東方インストライク - 
My Life Is A Party (Nightcore) - ItaloBrothers - 
Anima Libera (Nightcore) - Dj Raaban - 
Moonlight Shadow (Nightcore) - Mike Oldfield - 
Blackout (Nightcore) - Breathe Carolina - 
Ass up (Nightcore) - Baracuda - 
Dam Dadi Doo - Nightcore - Caliente - 
Cocaine (Nightcore) - Nomy - 
E.T. (Nightcore) - Katy Perry feat. Kanye West - 
Everytime We Touch (Nightcore) - Cascada - 
Disco Lazy Time - Nidji - 
Never Rains (Original Mix) (Nightcore) - Dance R Us - 
I&U (Nightcore) - Rei Yasuda - 
Never Rains [Hands Up] (Nightcore) - Dance R Us - 
Poison (Nightcore) - Alice Cooper - 
Rockefeller Street (Nightcore) - Getter Jaani - 
Only My Railgun (Nightcore) - fripSide - 
Waves (Danny R. Radio Edit) (Nightcore) - Dj Satomi - 
Don't Stop (Nightcore) - Foster the People - 
Say Hello (PreDancer Remix) (Nightcore) - Distinct - 
Future Cαndy (Ebon fuwari Remix) (Nightcore) - YUC'e (ゆーしえ) - 
Til Death (Technoposse Remix Edit) (Nightcore) - Til Death - Til Death - 
Classical VIP - NIGHTkilla - 
Nightcore This - S3RL feat. Tamika - 
好き?Suki! - Night Tempo x Tomggg - 好き?Suki! - 
Til Death (Technoposse Remix) (Nightcore) - Til Death - Til Death - 
Feeling Good - Nina Simone - Feeling Good: The Very Best of Nina Simone - 
Nite Cruising - Srav3R Feat. Numb 'N' Dub - FÜGENE2 - 
NightMaRe - SNoW - 
Checkpoint - Nitro Fun and Hyper Potions - Monstercat 027: Cataclysm - 
Night Of Fire - Niko - Super Eurobeat, Volume 174 - 
Kangpe - Nneka feat. Wesley Williams - No Longer at Ease - 
NMR - Tharu - 
Breakdown - Noisestorm - 
Machine Gun (16bit remix) - Noisia - Ministry of Sound: The Sound of Dubstep 2 - 
Heartbeat - Nneka - 
Machine Gun - Noisia - 
CHINATOWN HUSTLER - NOTORIOUS MSG - 
Notorious SNSD (Ben Shepperd Mashup) - The Notorious B.I.G. and SNSD - 
Not Fall in Love with You - Jeff Williams - RWBY: Volume 3 Soundtrack - 
Best Smile - nora2r vs. BlackY - Energy Of The Sun - 
Crazy Little Love - Nuage - Super Eurobeat Presents Initial D Final D Selection - 
Feather - Nujabes feat. Cise Starr & Akin - Modal Soul - 
Counting Stars - Nujabes - Hydeout Productions: 2nd Collection - 
Nou Shou Sakuretsu Girl - Rerulili feat. Kradness - 
Dragostea Din Tei - O-Zone - Hot Dance 2005 - 
Feel So Good - nyankobrq - POPOVER+TEATIME 3 - 
Kuusou Mesorogiwi (空想メソロギヰ) - Yousei Teikoku (妖精帝國) - 空想メソロギヰ - 
Unity & Emphatic - Obsidia - 
Say Yea - Older Grand and KBN NoOne - 
Shades Of Grey - Oliver Heldens & Shaun Frank feat. Delaney Jane - 
Voices - Ollie Crowe and Rich James feat. NK - 
Somewhere over the Rainbow - Israel Kamakawiwo'ole - 
Op Opps Op - Eureka PSYven - Triple-Q - GANGNAMCORE 2, Part II: ONLY OPPING! - 
rise - ORIGA - Ghost in the Shell STAND ALONE COMPLEX CD-BOX - 
Priorities - OHD - 
Melbourne Bounce (Deorro Remix) - Orkestrated and Fries & Shine featt. Big Nab - 
End of All (Below) (すべての路の果てに~煉) (English Version) - 森下弘生 - ファイアーエムブレム if ORIGINAL SOUNDTRACK - 
Not Alone - Otto Knows - Urban Dance Vol.19 - 
United (L.A.O.S Remix) - Our Stolen Theory - 
完全感覚Dreamer - ONE OK ROCK - 
X.U. - SawanoHiroyuki[nZk]:Gemie - X.U. | scaPEGoat - 
La La La Girl - Paffendorf - 
Ghosts Over Baghdad - Outkast vs Deadmau5 - 
Paint It Black - The Rolling Stones - Ten Licks From Forty Licks - 
Miss Jackson - Panic! at the Disco feat. Lolo - Too Weird to Live, Too Rare to Die! - 
버드맨 - P-Type (피타입) - 
Close Your Eyes for This - Parmalee - Feels Like Carolina - 
High Score - Panda Eyes and Teminite - 
Let Her Go - Passenger - Toggo Music 34 - 
I'm Coming - Pa's Lam System - I'm Coming - 
past days~追憶 - m.o.v.e - INITIAL D BEST SONG COLLECTION 1998-2004 - 
Patchwork Staccato (ツギハギスタッカート) (JubyPhonic English Cover) - TOA (とあ) feat. Hatsune Miku (初音ミク) - 
Ready Steady Go (Korean Style) - Paul Oakenfold feat. Asher D - 
I Will Give You My All - Simon Viklund - Payday - The Game Soundtrack - 
Catgroove - Parov Stelar - Samba - 
Ready Steady Go - Paul Oakenfold feat. Asher D - Bunkka - 
This Is Our Time - Miles Malone - 
Evil Eye - Simon Viklund - PAYDAY 2 Official Soundtrack - 
Blood Sugar - Pendulum - Blood Sugar / Axle Grinder - 
Superstar - Pegboard Nerds and NGHTMRE feat. Krewella - 
Sounds of Life - Pendulum feat. Jasmine Yee - Hold Your Colour - 
The Island, Pt. I: Dawn - Pendulum - Immersion - 
The Island (Madeon remix) - Pendulum - Immersion - 
All The Things She Said (DnB Remix) - PESS vs t.a.t.u - 
Vengeance - Perturbator - 
Daydream Cafe (you remix) - Petit Rabbit - 
Englishman in New York - PH Electro - Now That's What I Call Music 01 - 
Gust of Wind - Pharrell Williams feat. Daft Punk - Girl - 
Phase Craze - Israel Medina, Sample Magic & David Felton - 
King for a Day - Pierce the Veil feat. Kellin Quinn - Collide with the Sky - 
How It Is - Pheeno feat. Dalvin - 
Lost With You - Peter Kiemann feat. Jordi Davis - 
Time of Our Lives - Pitbull and Ne-Yo - 
LOVE ME - P*Light - Parking Panic EP  - 
Nee Lunar Lunar - Platinum Jet - 
Beautiful Lies (Nightcore) - B-Complex - 
I My Me Mine (All Star Ver.) - Polysics - 
Pomp and Circumstance / Ifuudoudou - Megurine Luka, Hatsune Miku, IA, GUMI and Kagamine Rin - 
Pop Danthology 2013 - Mashup of 68 songs! - Daniel Kim - 
P L U S H I E G U N - Doll.ia - 
Fade Away - the sub account - POPOVER+TEATIME 3 - 
Sad Machine (Darren Styles and Gammer Remix) - Porter Robinson - 
PiNK CAT - GARNiDELiA - MIRAI - 
Gangsta's Paradise Cover - Position Music 2WEI - 
Coexist (Jordan Andrew and Nick Anthony Remix) - Prismo - 
Roméo et Juliette : Les Montaigus et les Capulets (Dance of the Knights) (Parfum) - Gabriel Prokofiev - Trésors de la pub - 
Still Alive - Ellen McLain - 
Cherry Boy Rap Riot - Ken Ashcorp - 
Pursuit of Happiness (Steve Aoki remix) - Kid Cudi feat. MGMT & Ratatat - Pursuit of Happiness - 
Gentleman - PSY (싸이) - Gentleman - 
Gangnam Style (강남스타일) - PSY (싸이) - The Singles - 
Napal Baji (나팔바지) - PSY (싸이) - 칠집싸이다 - 
psychedelic soul - Scott Matthew - Ghost in the Shell STAND ALONE COMPLEX CD-BOX - 
Don't you want me - PSYQUI feat. Such - SPD GAR - 
DADDY - PSY (싸이) feat. CL of 2NE1 - 칠집싸이다 - 
Mend Your Ways - PSYQUI feat. Such - Such - innocent - 
Secret Dance Hall - PSYQUI feat. Such - Such - innocent - 
Your voice so...(Zekk's 'FULL SPEC' Remix) - PSYQUI feat. Such - Such - innocent - 
ヒステリックナイトガール (Awakening) - PSYQUI feat. Such - Such - innocent - 
Hype - PSYQUI Feat. Such - FÜGENE2 - 
LOVE&ROLL - PSYQUI feat. Such - Such - innocent - 
Don't you want me (Mameyudoufu Remix) - PSYQUI feat. Such - Such - innocent - 
Hype (sky_delta Remix) - PSYQUI feat. Such - Such - innocent - 
ヒステリックナイトガール (android52 Edit) - PSYQUI feat. Such - 
ヒカリの方へ (lapix & Cranky Remix) - PSYQUI feat. Such - Such - innocent - 
I LUV IT - PSY (싸이) - 4x2=8 - 
センチメンタルハートボーイ - PSYQUI feat. Such - Such - innocent - 
New Face - PSY (싸이) - 4x2=8 - 
오빤 딱 내 스타일 - PSY (싸이) feat. HYUNA;  - 
IDGAF (Original Dance Edit) - Punkrockerz feat. Carmen & Camille - 
Stargazer (Dj Shimamura Remix) - P*Light feat. Yukacco - 
Qrow vs Winter - Jeff Williams - RWBY: Volume 3 Soundtrack - 
Make It Wit Chu (Radio Edit) - Queens of the Stone Age - Make It Wit Chu - 
BOOM! BOOM!! BOOM!!! - P*Light - 
Make It Wit Chu (Virgin Magnetic Material Remix) - Queens of the Stone Age - 
Nandemonaiya (Movie Version) (It's Nothing) (なんでもないや) - RADWIMPS - Your Name - 
R4V3 B0Y - S3RL feat Krystal - 
Quand La Pluie Tombe - nymano - 
Dream Lantern (Yume Tōrō) (夢灯籠) - RADWIMPS - Your Name - 
Heart Of Steel - Raiden feat. Bright Lights - 
Sweet Surrender - Rameses B feat. Charlotte Haining - 
Anaconda / NYANACONDA (Nyanners Cover) - Nicki Minaj - 
Todestrieb - Rche - beatmania IIDX 19 Lincle ORIGINAL SOUNDTRACK - 
Red Like Roses (Red Trailer) - Jeff Williams (feat. Casey Lee Williams) - RWBY: Volume 1 Soundtrack - 
Red Like Roses Part I II Complete - Jeff Williams feat. Casey Lee Williams - 
Redstar - Receptor - 
Acceleration - REDALiCE - 
Redbone / Redgamers (Gamers vs Childish Gambino) (Triple-Q Mashup Remix) - Childish Gambino and Triple-Q - 
REDLINE DAY - James Shimoji feat. Rob Laufer - REDLINE Original Soundtrack - 
彼のシフトはブンブンブン - James Shimoji feat. SUPER BOINS - REDLINE Original Soundtrack - 
sudo apt-get install RENGE - rekanan - 
New World - Refeci and Robbie Koex feat. Micah Martin - 
Tokio Funka (トキヲ・ファンカ) (Reol (れをる) Cover) - GUMI - Gokusaishiki (極彩色) Tower ver. - 
Derezzed (The Glitch Mob Remix) - Daft Punk - 
These Nights - 88rising, Rich Brian & CHUNG HA - Head In The Clouds II - 
Dat $tick - Rich Chigga - Dat $tick - 
O Tebe - Ranetki Girls - 
ride on technology - Yoko Kanno - Ghost in the Shell STAND ALONE COMPLEX CD-BOX - 
Never Gonna Give You Up - Rick Astley - Media Markt Collection: The 80s, Volume 2 - 
Paradisus Paradoxum - MYTH & ROID - 
Umbrella - Rihanna feat. JAY-Z - Good Girl Gone Bad - 
Heatwave - Robin Schulz feat. Akon - Sugar - 
Willst Du (radio mix) - Robin Schulz & Alligatoah - Prayer - 
Heatwave (Hugel remix) - Akon feat. Robin Schulz - Après Ski Club Hits 2017 - 
ROCK DA PARTY - Seventhrun and Getty - Infinite Star - 
The Rockafeller Skank - Fatboy Slim - 100 Hits: 90s Pop - 
Same - Robin Schulz - Same - 
What Is a Youth (Love Theme From 'Romeo & Juliet') - Nino Rota - Romeo & Juliet - 
Kiss Me Again (Club Edit) - Roy Bee - 
Running in The "90's" - Max Coveri - Super Eurobeat Presents Initial D Special Stage Original Soundtracks - 
Rush Indigo - ak+q - 
Дикi танцi - Руслана - Grand Theft Auto IV: Vladivostok FM - 
Mirror, Mirror Extended - Jeff Williams feat. Casey Lee Williams - 
Armed and Ready - Jeff Williams feat. Casey Lee Williams - RWBY: Volume 4 Soundtrack - 
Bmblb - Jeff Williams feat. Casey Lee Williams - RWBY: Volume 4 Soundtrack - 
Boop (Acoustic Version) - Jeff Williams feat. Casey Lee Williams and Videri String Quartet - RWBY: Volume 4 Soundtrack - 
I May Fall (Harry Lodes Remix) - Jeff Williams feat. Casey Lee Williams - RWBY: Volume 4 Soundtrack - 
Lusus Naturae - Jeff Williams - RWBY: Volume 4 Soundtrack - 
Sacrifice (Harry Lodes Remix) - Jeff Williams feat. Casey Lee Williams - RWBY: Volume 4 Soundtrack - 
It's My Turn (James Landino Remix) - Jeff Williams feat. Casey Lee Williams - RWBY: Volume 3 Soundtrack - 
R.W.B.Y. vs F.N.K.I. - Jeff Williams - RWBY: Volume 3 Soundtrack - 
ODDS&ENDS - ryo (supercell) feat. Hatsune Miku (初音ミク) - ODDS&ENDS - 
Merry Christmas Mr. Lawrence - 坂本龍一 - One World - 
Merry Christmas, Mr Lawrence - Ryuichi Sakamoto - 
Bass Slut - S3RL - Bass Slut / It Went / Crazy Ass Bitch - 
Kids (Paramond Extended Mix) - Robokids - 
MTC (Different Heaven Remix) - S3RL - 
Pika Girl - S3RL - Super Fun Happy Time - 
T-T-Techno - S3RL - T-T-Techno / Every Single Day / Stomp Ya Feet - 
Rainbow Girl - S3RL - 
Friendzoned - S3RL feat. Mixie Moon - 
I Will Pick You Up - S3RL feat. Tamika - 
It Went - S3RL feat. JessKah - Bass Slut / It Went / Crazy Ass Bitch - 
Mal Hbibi Malou (سعد لمجرد - مال حبيبي مالو) - Saad Lamjarred - 
Mandragora - SaberZ - 
Sad Romance (Sad Violin) (Violin Version) - Ji Pyeongkeyon - 
Further - Sadkey - 
Sad Romance (Voice Ver) - Ji Pyeongkeyon - 
Sad Romance (vvmusic Ver) - Ji Pyeongkeyon - 
Wallflower - Kevin and Carrick - 
Sakasama no Chou - SNoW - 
Independent Puppet - Sakuzyo (削除) - Pop Candy Wonderland - 
Irondust - Sakuzyo (削除) - AngelFalse - 
rePrologue - Sakuzyo (削除) - LAST DANCE - 
The void - Sakuzyo (削除) - AngelFalse - 
Samurai Flamenco Theme - Yusuke Naruse - 
Shiki No Uta (四季ノ唄) - MINMI - アイの実 - 
Shiki No Uta (SparX Beats remix) - MINMI - 
七色アニバーサリー - 桜華P feat. V3 GUMI (Power) - Altemis Heart - 
Sandstorm - Darude - Ahora '01 - 
All MY People - Sasha Lopez and Andreea D feat Broono - 
Save Me (Extended Mix) - Leslie Parrish - Super Eurobeat, Volume 98 - 
Colorful (Asterisk Remix) - Sawai Miku - 
会わないつもりの、元気でね - SCANDAL - Greatest Hits - 
Kagen no Tsuki (下弦の月) - SCANDAL - Greatest Hits - 
Shoujo S (少女S) - SCANDAL - 少女S - 
Shunkan Sentimental (瞬間センチメンタル) - SCANDAL - 鋼の錬金術師 THE BEST - 
Collard Greens - ScHoolboy Q feat. Kendrick Lamar - Oxymoron - 
Ave Maria - Franz Schubert - The Best of Barbara Bonney - 
Sea of Sand (Wipeout mix) - Guy Gerber & Shlomi Aber - Wipeout Pulse - 
119 - Sean & Bobo - 
Swing It - Sean & Bobo - 
Domination (Original Mix) - Sean & Bobo - 
Drop The Bass Low - Sean & Bobo - 
In The Air - Sean & Bobo - 
See you, my best love - m.o.v.e - electrock - 
killy killy JOKER - 分島花音 - killy killy JOKER - 
world's end, girl's rondo - 分島花音 - ツキナミ - 
rog-unlimitation - 07th expansion - 
Senbonzakura - Lindsey Stirling - 
Septette for the Dead Princess (Vocal Orchestra) (永遠に幼き紅い月) - Silver Forest - Silver Forest 2006-2012 BEST2 - 
KIMCIL - SEREMPET GUDAL - 
Setsunairo 1979 - Yuyushiki x The Smashing Pumpkins - 
shadowgraph - MYTH & ROID - shadowgraph - 
Hips Don't Lie (video) - Shakira feat. Wyclef Jean - Oral Fixation, Volumes 1 & 2 - 
CYBER INDUTANCE - DJ Sharpnel - RUNNING ALL NIGHT!! - 
Marble Soda (live mashup) - Shawn Wasabi - 
Uncool Lunch Tables (Skrillex Recess Mashup) - Shawn Wasabi - 
Electric Girl - she - Electric Girl - 
She so Ugly - Kevjumba and Nigahiga - 
Senpai (MajorLeagueWobs Remix) - Shiki(TMNS) feat. Hentai Dude - 
The Final Cypher (Senpai) (Production MajorLeagueWobs) - Shiki(TMNS) feat. etc - 
Senpai - Shiki(TMNS) feat. A.O.Lyrical - 
Who Are You? - Shiki feat. Doll.ia - 
Shine - Jeff Williams feat. Casey Lee Williams - RWBY Volume 2 Soundtrack - 
Shine Spark (Vocal Cover) - VA-11 HALL-A feat. Adriana Figueroa and Garoad - 
Prism - SHINee (샤이니) - 1 of 1 - 
Animetic Love Letter - Aoi Miyamori, Ema Yasuhara and Shizuka Sakaki - 
Home - ShockOne feat. Reija Lee - 
GBA - shoji - 
❤ Bubble Tea Date ❤ - shoji - 
You Reposted In The Wrong Neighborhood (Dunclub Extended Mix) - ＳＨＯＫＫ青 - 
Elastic Heart - Sia - 1000 Forms of Fear - 
The Wolf - SIAMÉS - 
Nobody to Love (extended mix) - Sigma - Nobody to Love - 
Hoppípolla - Sigur Rós - Takk... - 
never gonna stop - simplí feat. Kim Mckenzie - 
SKIP - Chata (茶太) - グリザイアの果実 エンディングテーマ集&オリジナルサウンドトラック - 
Septette for the Dead Princess - Senya - 
Scary Monsters and Nice Sprites - Skrillex - Greatest Hits & Remixes - 
Singshot (Wipeout mix) - Rennie Pilgrem & BLIM - Wipeout Pulse - 
Sulfur Music Video - Slipknot - (sic)nesses - 
Smart Systems - MIST - Wipeout Pulse - 
Love Residue - SMLE feat. Jackie's Boy - 
Candy Dash - Ujico* /Snail's House - CandyGirl - 
雪の降る街で、あなたを待っている。 (waiting for you, in snowing city.) - Snail's House - Snö - 
Pastel - Snail's House × Moe Shop - 
Rhythm Is a Dancer - Snap! - Fetenhits: Silvester 2014 - 
Snoop Dogg (Explicit) - Snoop Dogg - Snoop Dogg / Back Up Ho - 
soda city funk - Tim Legend - soda city funk - 
Tainted Love - Soft Cell - Smash Hits Party - 
Honolulu how do you do - Sol K. Bright's Hollywaiians - 
Solitude - nymano - 
Something Stupid - Nancy Sinatra - Nancy Sinatra and Friends - 
Song of Storms (dubstep remix) - Ephixa - Zelda Step - 
Song of Storms - 
Bi☣hazard VOCALOID Cover - SONiKA - 
Move That Body -Extended Mix- - Sota Fujimori - SYNTHESIZED5 - 
monochrome (Asterisk Makina Remix) - Asterisk - Asterisk Works 3 - 
Murder - Soulji - Black Mask EP - 
Moonlight Ginga (ムーンライト銀河) - Sōtaisei Riron (相対性理論) - シンクロニシティーン - 
Space-Time - S3RL feat. Riddle Anne - 
Sigmund - Gram - beatmania IIDX 21 SPADA ORIGINAL SOUNDTRACK VOL.2 - 
Crossroads (Fusq remix) - Sparx - 
HERO (히어로) - MONSTA X (몬스타엑스) - RUSH - 
Black Betty - Spiderbait - 
Spoiler Alert - S3RL feat. DEFI BRILATOR - 
Let Me Hit It (Audiostalkers mix) - Sporty-O - Let Me Hit It - 
「JUST ONE LIFE」（フジテレビノイタミナアニメ「サムライフラメンコ」オープニング・テーマ）  - SPYAIR - 
Speed Complex - Srezcat & Kobaryo - ABSOLUTE - 
Bassdrum Catharsis - Srezcat & Kobaryo - METAMORPHOSE - 
Pizza Rolls - Shawn Wasabi / sssShawnnnn - PIzza Rolls - 
Pizza Rolls (metal x EDM mashup) - Shawn Wasabi - 
Hold On - St. Albion feat. Teischa - 
5 Centimeters Per Second - Star Driver - 
I Was the Sun (Before it was Cool) - Curtis Schweitzer - Starbound - 
Music Sounds Better With You - Stardust - Fresh FM 90's Dance! - 
Make It Bun Dem - Skrillex & Damian "Jr. Gong" Marley - Make It Bun Dem: After Hours EP - 
Starstruck - Lady Gaga feat. Space Cowboy & Flo Rida - Disco Heaven: The Fame B=2.0 - 
#StartAgain - OllyP - 
Steady Rush - BOOKA SHADE - Wipeout Pulse - 
Commodus Pt.1 (The Arrival) - Stefan Nixdorf - 
Commodus The Menace (Pt.2) - Stefan Nixdorf - 
Dedenne - Stepic - 
夕暮れスターライド - Stereoman - POPOVER+TEATIME 3 - 
Future Cαndy (Stereoman Remix) - YUC'e (ゆーしえ) - 
Hitohira no Hanabira - Stereopony - Japan Nite Sound Sampler 2009 - 
Show Me Love - Steve Angello & Laidback Luke feat. Robin S. - The Biggest Breakdowns of All Time - 
Englishman in New York - Sting - Millennium Gold - 
Be Alright - Stonebank feat. EMEL - Monstercat 027: Cataclysm - 
Put 'em High - Stonebridge feat. Therese - 
Stranger Bonfires - kmlkmljkl - 
stranger_think - C418 - 2 years of failure - 
Tous les mêmes - Stromae - Racine carrée - 
Let's Go - Stuck in the Sound - Pursuit - 
Party Like It's Your Birthday - Studio Killers - Party Like It's Your Birthday - 
Syrup - Stwo - 
STYX HELIX (dj-Jo Remix Extended) - MYTH & ROID feat. Akano  - 
Intracerebral Synapse Rebellion (脳内シナプスの叛逆) - KagomeP feat. Hatsune Miku (初音ミク) - 
Changes - Suken and Fusq - Owarini Tokyo Liveshow  - 
Kimino Shiranai Monogatari - Supercell - 
LOVE & ROLL - supercell - Today Is A Beautiful Day - 
Parade of liars (嘘つきのパレード) (Usotsuki no paredo) (Band Edition) - supercell - 
Surfing on a Sine Wave - Fearofdark - Motorway - 
See You - Sushi Killer - 
Waifu Dream - Sushi Killer - 
Zora (Live Mashup) - Sushi Killer - 
Pony Swag - Swagberg feat. Maros - 
Miami 2 Ibiza - Swedish House Mafia vs. Tinie Tempah - Disc-Overy - 
Antidote (radio edit) - Swedish House Mafia & Knife Party - Antidote - 
Sweet Devil (colate Remix) - Hachioji-P (八王子P)/8#Prince feat. Hatsune Miku (初音ミク) - 
Right Back - SWRVN x Razz - 
Anti-HeroiK - Synagi - Krazy Psycho Bass 2 - 
Strangers - Synchronice - 
Lights (Cross Them Out Remix) - System feat. Veela - 
TV Tokyo (テレ東) - Sōtaisei Riron (相対性理論) - ハイファイ新書 - 
Vermont Kiss (バーモント・キッス) - Sōtaisei Riron (相対性理論) - ハイファイ新書 - 
Hell Teacher / Jigoku Sensei (地獄先生) - Sōtaisei Riron (相対性理論) - ハイファイ新書 - 
(The title is) TOO LONG to write here. - t+pazolite - Bright Colors - 
Call me it. (500 Tortures) - t+pazolite - 
cheatreal - t+pazolite - Answer from X Girlz - 
Ultrasonic Anthem - t+pazolite - Voltage Ignition 2 - 
All the Things She Said - t.A.T.u. - Now Dance 2003 - 
Kick-ass Kung-fu Carnival - t+pazolite - Hardcore Syndrome 5 - 
Drip Drop - TAEMIN (태민) - Press It - 
take me higher - m.o.v.e - electrock - 
Tank! - シートベルツ - COWBOY BEBOP - 
Emotions (キドアイラク) - Task feat. Hatsune Miku (初音ミク) - 
IMAGE -MATERIAL- (Version 0) - Tatsh - 
reunion <Platinum Long Version> - Tatsh - MATERIAL - 
Nas Ne Dogonyat (Нас не догонят) - t.A.T.u. - 200 km/h in the Wrong Lane - 
I Knew You Were Trouble - Taylor Swift - 
Shake It Off (Music Video) - Taylor Swift - Shake It Off - 
Promesses (radio edit) - Tchami feat. Kaleem Taylor - Ministry of Sound: Back to Bass - 
Head Over Heels - Tears for Fears - The Ultimate Collection - 
Dysfunctional - Tech N9ne feat. Big Scoob & Krizz Kaliko - Collabos: Sickology 101 - 
Worldwide Choppers - Tech N9ne - 
Fly Away (Fusq Remix) - TeddyLoid - 
Capture My Attention - TeeTs - 
The Light (Original Mix) - Tetrix Bass feat. Veela - 
Tell Me What You Want - S3RL feat. Tamika - 
Sugar, Sugar - The Archies - The 60's Decade: Number One Hits - 
Rock That Body - The Black Eyed Peas - Radio 538 Hitzone 53 - 
Warp 1.9 - The Bloody Beetroots - Warp - 
Swoon (Boys Noize Summer Mix) - The Chemical Brothers - 
Swoon (radio edit) - The Chemical Brothers - The Chemical Brothers - 

Our Demons - The Glitch Mob feat. Aja Volkman - 
We Can Leave the World - Boppin' B - We Can Leave the World - 
Future Starts Slow - The Kills - Festival La Route du Rock, la Compilation 2011 - 
Falco - Hitomi Shimatani - 
California Dreamin' - The Mama's and the Papa's - If You Can Believe Your Eyes and Ears - 
LAST DINOSAUR - the pillows - HAPPY BIVOUAC ON THE HILLARI STEP - 
Spitfire - The Prodigy - 
Ragnarok - Gram vs Camellia (かめりあ) - The Requiem - 
Scatman - Scatman John - Chart Busters: 40 Mega Hits - 
1979 - The Smashing Pumpkins - 1979 - 
The Sound of Silence - Art Garfunkel - Up 'til Now - 
The Top - Ken Blast - Super Eurobeat Presents Initial D Final D Selection - 
Untouched - The Veronicas - Miss Independent: From the Ladies of Pop - 
Seven Nation Army - The White Stripes - Triple J: Hottest 100 of All Time - 
Shikaku Kakumei (四角革命) - Sōtaisei Riron (相対性理論) - ハイファイ新書 - 
The House of the Rising Sun - The Animals - The Animals - 
Jungle - The Brig - 
Closer - The Chainsmokers feat. Halsey - Closer - 
Tell Him - The Exciters - Rock, Rhythm and Doo Wop: The Greatest Songs From Early Rock 'n' Roll - 
Superman - The Lucky Laki - 
THE MILLION-YEAR PICNIC - CaptainMirai (キャプテンミライ) feat. lasah - INNOCENCE - 
The Real Disappearance of Hatsune Miku - cosMoBousou-P feat. GUMI - 
This is Genius level Hiphop - Ohene Savant - 
This Life is Mine - Jeff Williams feat. Casey Lee Williams - RWBY: Volume 4 Soundtrack - 
This Will Be the Day - Jeff Williams (feat. Casey Lee Williams) - RWBY: Volume 1 Soundtrack - 
This Will Be the Day (James Landino's Magical Girl Remix) - Jeff Williams feat. Casey Lee Williams - 
Booka Shake (Original Mix) - Thomas Jack - 
Inspire - Throttle - Throttle - Inspire - 
Through the Years 2018 - S3RL & Zero-2 feat. Yurino - 

Time To Say Goodbye - Jeff Williams feat. Casey Lee Williams - 
Time to Say Goodbye (Acoustic) - Jeff Williams feat. Casey Lee Williams - RWBY: Volume 3 Soundtrack - 
Freaks (radio edit) - Timmy Trumpet & Savage - Freaks - 
Written in the Stars - Tinie Tempah feat. Eric Turner - Bravo Black Hits, Volume 23 - 
Pass Out - Tinie Tempah - Now That's What I Call Running 2014 - 
Written in the Stars - Tinie Tempah feat. Eric Turner - Bravo Black Hits, Volume 23 - 
to Luv me I *** for u. - t+pazolite - HARDCORE SYNDROME 2 - 
Makudonarudo (東京盆踊) - Namewee (黃明志) feat. Meu Ninomiya (二宮芽生) - 亞洲通吃 - 
Tokyo Drift (Fast & Furious) - Teriyaki Boyz - Serious Japanese - 
Lean Back - Terror Squad - Black Winter Party - 
Sex Bomb - Tom Jones - 
Tokyo - Stanton Warriors - Wipeout Pulse - 
Broken String - Tek-One - Ministry of Sound: The Sound of Dubstep - 
Where It Hurts - Tom Reev, Assix, and Jason Gewalt - 
Danger (The Bomb) - Tonite Only - 
Where the Party's At - Tonite Only - Ministry of Sound: The 2007 Annual - 
Stay High (Habits remix) - Tove Lo feat. Hippie Sabotage - NRJ Music Awards 2014 - 
diskommunication - t+pazolite - Answer from X Girlz - 
Howling Down - t+pazolite - songs for X Girlz - 
Kick-ass Kung-fu Carnival (RoughSketch Remix) - t+pazolite - 108 Sketches 5 - 
Oshama Scramble! (uncut edition) - t+pazolite - Ponko2 Girlish - 
Datamania - t+pazolite - IRREGULAR NATION 4 - 
CENSORED!! - t+pazolite - t&T. "tpz And TOUHOU" from 2005 - 
Must Be Done - t+pazolite - TRI▼FORCE - 
TENO-HIRA - CaptainMirai (キャプテンミライ) feat. lasah - "I LOVE YOU," - 
Fast Car - Jonas Blue feat. Dakota - Radio 538 Hitzone 76 - 
Mission ASCII - Traktion - 
Military Storm - Dj Bjra / Trance - 
Flying High (DJ Splash Remix Nightcore) - DC-10 (DCX) - 
Transparent Elegy - n-buna and GUMI - 
Sega Genesis - Trevor Something - 
Ochansensu-su (おちゃんせんすぅす) - tricot - T H E - 
Tsubasa wo Kudasai (翼をください) (Cover) - Yandere Dev - 
Tsubasa wo Kudasai (翼をください) - Megumi Hayashibara (林原めぐみ) - EVANGELION:2.0 YOU CAN (NOT) ADVANCE. original sound track - 
Dr. Who! (Smooth remix) - Tujamo & Plastik Funk feat. Sneakbo - Viper presents: Drum & Bass Summer Slammers 2014 - 
Ravers Fantasy - Manian - Club Sounds: The Ultimate Club Dance Collection, Volume 49 - 
Horns Up - Tuzulto X Stompede - 
Epiphany - TwoThirds and Feint - 
How I Feel - Tyler Cassidy - 
U.N. Owen Was Her? (Batsu Remix) - Batsu - 
dreamenddischarger - GranMusik - TVアニメーション 「うみねこのなく頃に」 Original Sound Track ~Rose Crimson~ - 
U.N.オーエンは彼女なのか? - TAMUSIC - 東方バイオリン7 - 
Everthing Will Freeze - Undead Corporation - 
Yoru Naku Usagi wa Yume wo Miru (紅染の鬼が哭) - Undead Corporation - 
Once Upon a Time (Arcien Remix) - Toby Fox - 
Dream Catcher - Unicorn Kid - Sound Of The Summer - 
Out of Touch - Uniting Nations - Jetix Vakantiehits 2005 - 
Beautiful Light - Uppermost - Control - 
Sakura Era - USAO - Kick's For Liberation - 
Vacuum Break - USAO - Kick's For Liberation - 
Hop Step Instant Death A Happiness Dance Death-Trap - UtataP feat. 初音ミク - 
Lubricates - V e g e t a b l e s - 
Your Love is a Drug (insaneintherain Arrange) (Vocal Cover) - VA-11 HALL-A feat. Adriana Figueroa - 
Your Love is a Drug (Vocal Cover) - VA-11 HALL-A feat. Sabrina Valenzuela - 
Make Me Fade - Vanic x k.flay - Make Me Fade - 
What's New Pussycat - Tom Jones - 
Can't Sleep - Vanic x K.Flay - Can't Sleep - 
We Run The Night - Tonite Only - 
Ven báilalo - Angel y Khriz - Caribe 2005 - 
Hajnal - Venetian Snares - Rossz csillag alatt született - 
My New Swag - VaVa feat. Ty & Nina Wang - Crazy Rich Asians: Original Motion Picture Soundtrack - 
Biddie Bounce - Venice - 
Kurt Cobain - Veronica Maggio - Fiender är tråkigt - 
Måndagsbarn - Veronica Maggio - Big Hits - 2009 - 
Vida - Venetian Snares - D-Side 23 - 
Tillfälligheter - Veronica Maggio - Fiender är tråkigt - 
Heartbeat - Vicetone feat. Collin McLoughlin - 
Perjuangan - Vierratale feat. Ilyas *Kevin and the Red Rose" - 
Petit Girlfriend - ViZ0R (SOUNDSCVPE) - 
Half Step - livetune feat. 初音ミク - Tell Your World EP - 
Party x Party - Vocaloid Six - 
(Vocal) you - 霞ヶ丘詩羽(CV.茅野愛衣) - 冴えない彼女の育てかた 第4巻 特典CD - 
Superstar (Original Mix) - Vonikk - 
Wait For The Moment - Vulfpeck feat. Antwaun Stanley - 
Revenge of Nautilus - Vøldø - 
Cari Jodoh - Wali - Cari Jodoh - 
Walk It Talk It Kiss It (Triple-Q Mashup) - Darling in the FranXX vs. Migos & Drake and Triple-Q - 
Are You Bored Yet? - Wallows feat. Clairo - Nothing Happens - 
King of my castle - Warmdue Project - 
Wanna fly to be wild - m.o.v.e - electrock - 
我的歌声里 (You Exist in My Song) - Wanting - Everything in the World - 
Ancient Warrior - Warptech - 
Jag kommer - Veronica Maggio - More Music 2012 - 
Boom, Boom, Boom, Boom - Vengaboys - Sunshine '99 - 
Waters of Megalovania - BotanicSage - 
Cherry Pie - Warrant - The Rock and Roll Decades: The Nineties - 
Weapon of Choice - Fatboy Slim - Star 69 (What the F**K) / Weapon of Choice - 
More Bounce (In California) - Soul Kid #1 - Legally Blonde 2: Red, White & Blonde - 
Bump & Grind - Waze & Odyssey vs. R. Kelly - 
Amish Paradise - "Weird Al" Yankovic - The Essential "Weird Al" Yankovic - 
Touched - What So Not - 
White & Nerdy - "Weird Al" Yankovic - Absolute Music 53 - 
what's it for - Emily Curtis - Ghost in the Shell STAND ALONE COMPLEX CD-BOX - 
What Lies at the End - Takeru Kanazaki (金﨑猛) - Fire Emblem Echoes: Shadows of Valentia Original Soundtrack
 - 
What Redbone would sound like if X Gon Give It To Ya (Redbone and X Gon' Give It To Ya Mashup) - Childish Gambino and DMX - 
ID - What So Not - 
When I Die - S3RL feat. Razor Sharp and Krystal - 
When It Falls - Jeff Williams feat. Casey Lee Williams - RWBY: Volume 3 Soundtrack - 
Where Did You Go - S3RL feat. Charlotte - 
Why'd you only call me when you're high - Arctic Monkeys - 
Whirlwind - S3RL feat. Krystal - 
Windowlicker 33 RPM Vinyl (slow) - Aphex Twin - 
Acetone - The Crystal Method - Wipeout HD Fury - 
Le Night Dominator - The Touch - Wipeout HD Fury - 
World's End, Girl's Rondo (Asterisk DnB Remix) - Kanon Wakeshima - 
House of the Rising Sun - Wilbert Eckart und seine Volksmusik-Stars - Wolfenstein: The New Order Original Game Soundtrack, In-Game Music - 
Black And Yellow - Wiz Khalifa - The Chronic 2010 - 
Hook Shot - Wolfgang Gartner - Kindergarten - 
Illmerica - Wolfgang Gartner - DefQon.1 2011 - 
The American Epic (PrototypeRaptor Bootleg) - Wolfgang Gartner - 
What You Want - Wizard and Matbow -  - 
Clap - Wolfgang Gartner - Kindergarten - 
Need Your Love - Wreckless and Rivo - 
About the Dutch - Woodie Smalls - De Maxx Long Player 35: The Remix Edition - 
Little Too Close - WRLD feat. Veronika Redd - Monstercat 024: Vanguard - 
X-Project (100% Pure mix) - DJ Fresh - Wipeout Pulse - 
k1ll◎iLL - 澤野弘之 - KILL la KILL ORIGINAL SOUND TRACK - 
Happy End of the World (ハッピーエンドオブザワールド) - xi - Agartha - 
I kinda just wish it would disappear (消えてしまえたならいいのに、なんて) - Xotic Kamatani ft. Hatsune Miku (初音ミク) - 
Bochka, Bass, Kolbaser (Бочка, Басс, Колбасер) - XS Project - Гоп FM: Pump - 
Siuda Kalatuszek - XS Project - 
Harumodoki - Nagi Yanagi - 
Venus to Jesus (ヴィーナスとジーザス) - Etsuko Yakushimaru (やくしまるえつこ) - RADIO ONSEN EUTOPIA - 
FREEDOM DiVE↓ - xi - Parousia - 
BLACK RAIN - Yashiro Tsurugi (CV Yoshimasa Hosoya)(剣弥代(CV.細谷佳正)) - 幻影異聞録♯FE ボーカルコレクション - 
LAX - Xzibit - Weapons of Mass Destruction - 
Ya soshla s uma (Я сошла с ума) - t.A.T.u. - 200 km/h in the Wrong Lane - 
Drink Up - YeahRight feat. Azuria Sky - 
River Flows In You (A Love Note) (Original Mix) - Yiruma & Skullee - 
River Flows in You - 이루마 - 아기의 감성지수(EQ)를 높이는 피아노 태교음악 - 
The Fox (What Does the Fox Say) - Ylvis - Hitbreaker 2/2014 - 
Yatsuzaki (The Northern Hardcore) (Komarovski remix) - Quil feat. DD"ナカタ"Metal - The Far East Hard Session - 
Lucky Batch - you - Lilium X4 - 
YOU'RE EVERYTHING - Dark Cat feat. juunana - 
YMCA - Village People - FriendsReunited.co.uk '70s Party - 
You Reposted in the Wrong Neighborhood - ＳＨＯＫＫ青 - 
Cappchino - YUC'e (
ゆーしえ) - macaron moon - 
Cinderella Syndrome - YUC'e (ゆーしえ) - Future Cαndy - 
PUMP - YUC'e (ゆーしえ) - FÜGENE - 
Future Cαndy (Huichang Remix) - YUC'e (ゆーしえ) - 
Future Cαndy (Daniel Seven Remix) - YUC'e (ゆーしえ) - 
Future Cαndy (Snail's House Remix) - YUC'e (ゆーしえ) - 
macaron moon - YUC'e (ゆーしえ) - macaron moon - 
Night Club Junkie - YUC'e (ゆーしえ) - macaron moon - 
Sengoku HOP (戦国HOP) - YUC'e (ゆーしえ) - Athenarium  - 
Summer Lover!! - YUC'e (ゆーしえ) - Toy Frappe - 
Sunset Tea Cup - YUC'e (ゆーしえ) - FREQUENCY BLITZ 5 - 
Tick Tock - YUC'e (ゆーしえ) - Future Cαndy - 
Future Cαndy (Xignality Remix) - YUC'e (ゆーしえ) - 
Future Cαndy (Dream Hackers Remix) - YUC'e (ゆーしえ) - 
かくしごと - ゆいこんぬ - 虹色ショコラティエ - 
Strawberry Karte (すとろべりーカルテ) - Yunomi feat. Momobako (桃箱) - 
ダンスフロアの果実 - Yunomi feat. nicamoq - 
Yakimochi no Kotae -another story- - Yuikonnu - 
Indoor Kei Nara Trackmaker (インドア系ならトラックメイカー) - Yunomi and nicamoq - 
SHINY DAYS - Asaka (亜咲花) - SHINY DAYS - 
Tsubasa wo Kudasai (翼をください) - YUI - 
Poltergeist - Zatox feat. Nikkita - Raw Style EP - 
Stay the Night - Zedd feat. Hayley Williams of Paramore - Stay the Night - 
Midnight Sweet - Zekk - 
Kernkraft 400 - Zombie Nation - Megahits 2000: Die Erste - 
Blackjack - ゆちゃP feat. 巡音ルカ - EXIT TUNES PRESENTS Megurhythm - 
Akasagarbha - wa. vs Etia. - 
Runnin Around (Favulous Remix) - Zak Waters - 
Haru Modoki x Invitation - Nagi Yanagi - 
Le Disco - Henry Fong - 
プレインエイジア (Plain Asia) - Dark PHOENiX - Arrow Rain - 
Snake Eyes - Feint feat. CoMa - Monstercat - Best of DnB & Drumstep, Vol. 2 - 
Romeo and Cinderella - CUL - 
Homebound - Feint - Monstercat - The Best of 2013 - 
All Alone - Pegboard Nerds & Grabbitz - Monstercat 026: Resistance - 
Frightmare - Strangers feat. Myles Travitz - 
Timeless - Rameses B feat. Veela - Monstercat 015: Outlook - 
Moving On - Stonebank feat. EMEL - Monstercat 018: Frontier - 
如月アテンション - じん feat. 春奈るな - メカクシティアクターズ 2「如月アテンション」 - 
Pressure - Draper feat. Laura Brehm - Monstercat 021: Perspective - 
Daia no Hana (ダイアの花) - Yorico (より子) - second VERSE - 
ロミオとシンデレラ - Doriko feat. 初音ミク - ベスト '07-'09 Impacts - 
Anime Bae - Sushi Killer & Kevin Villecco - Monstercat 019: Endeavour - 
ヤキモチの答え - HoneyWorks feat. 望月蒼太(CV:梶裕貴) - 僕じゃダメですか? - 
Chemical Emotion ケミカルエモーション - GUMI and Rin - 
Razor Sharp - Pegboard Nerds & Tristam - Razor Sharp - 
KiLLER LADY - 8#Prince feat. GUMI - ×××× the ripper - 
人生リセットボタン (Jinsei Reset Button / Life Reset Button) - kemu feat. GUMI - Happy Party☆彡 - VOCALOID(tm)3 Megpoid(GUMI) - - 
Pizza Planet - Stephen Walking - Monstercat - The Best of 2013 - 
Stronger - Stonebank feat. EMEL - Monstercat 021: Perspective - 
Just Another Night (Nightcore) - Icona Pop - 
Vitality (t+pazolite Remix) - Mittsies - 
Tonight - Stereotronique & Sebastian Ivarsson feat. Danyka Nadeau - Monstercat 012: Aftermath - 
dawn - kamome sano - Oriens/dawn EP - 
ERROR [VOCALOIDカバー] - IA - 
Scarlet Rose - Lily - 
Narcissus - 
Party Junkie - さつき が てんこもり feat. Hatsune Miku (初音ミク) - V♥25 -Exclamation- - 
Awoo - 김예림 - Simple Mind - 
광화문 (Gwanghwamun) - P-Type ft. 태완 (Taewan) - Street Poetry - 
アシンメトリー (Asymmetry) - ギガP (Giga-P) feat. れをる (Reol) & L.Petty - No title- - 
Mr. (ミスター) - KARA (카라) - スーパーガール - 
Marie-Luise - Lily - 
Heads Will Roll (A-Trak Remix) - Yeah Yeah Yeahs - Heads Will Roll - 
BLACK or WHITE? - BlackYooh vs. siromaru - SOUND VOLTEX ULTIMATE TRACKS -LEGEND OF KAC- - 
Selection Of Life - TeddyLoid - Electric Alice - 
TRIGGER★HAPPY (Extend Ver.) - P*Light - HAPPYMAKER - 
威風堂々 - 梅とら feat. 巡音ルカ、初音ミク、GUMI、IA、鏡音リン&MAYU - EXIT TUNES PRESENTS Vocalofuture - 
Chase It - WRLD feat. Savoi - Monstercat 023: Voyage - 
This Is Rock 'n' Roll - [X]-Rx - Update 3.0 - 
Tear Rain - えみぃ - Radical Destruction - 
WAVE - vocaloid chorus - 
(Plus Danshi) - Reol (れをる) - 
Anchor (Noisestorm remix) - Tritonal - Anchor (remixes) - 
All the Things She Said (TOXiC Remix) - T.A.T.U - 
寄明月 (三无&泠鸢yousa Cover) - SING女團 - 
Internet bitch P*Light Remix - DJ'TEKINA//SOMETHING - DJ'TEKINA//SOMETHING - 
Waifu Dream (Ephixa Remix) - Sushi Killer  - 
Collide - Fractal feat. Danyka Nadeau - Gaia - 
Love Doll ラブドール 【UTAUカバー】 - Gahata Meiji - 
iNSaNiTY (feat.SF-A2 miki&KAITO) - Circus-P - iNSaNiTY -EP DLX - 
Parade of Liars (嘘つきのパレード) - supercell feat. Hatsune Miku (初音ミク) - supercell - 
IMAGINARY LIKE THE JUSTICE - GUMI - 
Dialing Paranoia - IA - 
SEE THE LIGHTS - IA feat. Asy - 
FUNKY SUMMER BEACH - P*Light - jubeat saucer ORIGINAL SOUNDTRACK -7 Bros.- - 
いちぬけ / 能登麻美子 (Ichi Nuke) - 能登麻美子 (Noto Mamiko) - 地獄少女 三鼎 オリジナルサウンドトラック~肉喰~ - 
六兆年と一夜物語 - kemu feat. IA - IA THE WORLD ~風~ - 
Love is War (恋は戦争) - supercell feat. Hatsune Miku (初音ミク) - supercell - 
When the First Love Ends - Hatsune Miku - 
Transparency Elegy - Ouka Alice - 
You (Vocal) - 癒月 - Thanks/you - 
All Right - Lim Kim (김예림) - A Voice - 
Super Nuko World - Yuikonnu and Ayaponzu - 
only my railgun (カラオケ) - fripSide - only my railgun - 
Senbonzakura (千本桜) - Kurousa-P (黒うさP) feat. Hatsune Miku (初音ミク) - EXIT TUNES PRESENTS Vocalodream - 
FIRST (UTAU cover) - 重音テト - 
Miss You - Nhato - Stir Up Club Edition V3 | diaphanser - 
WAVE - Lily - 
World is Mine (ワールドイズマイン) - supercell feat. Hatsune Miku (初音ミク) - supercell - 
God knows... - 平野綾 - AYA MUSEUM - 
花は幻想の果てに - Halozy - Halozy Alternative Outside 2010 Winter - 
i ωɒN̂t iẗ ThÅt ωay (i want it that way) - ΔMUNOA - Culture - 
αcquainτed - dante - 
Tatarin (Татарин) - Aigel (Аигел) - 1190 - 
На стиле - Время и Стекло - На стиле - 
Ju-Ju (Жу-Жу) - Leningrad (Ленинград) feat. Gluk’oZа (Глюк'oZa), ST - Жу-Жу - 
Ju-Ju (Жу-Жу) - Leningrad (Ленинград) feat. Gluk’oZа (Глюк'oZa), ST - Жу-Жу - 
Hasty Boom Alert - μ-Ziq - Lunatic Harness - 
Я КРОКОДИЛ (LACOSTE) - Stas Exstas (СТАС ЭКСТАЗ) - 
Я КРОКОДИЛ (OFFICIAL STREET VIDEO) - Stas Exstas (СТАС ЭКСТАЗ) - 
раз раз раз-это Hardbass (Хард Басс) - Dj Железные Шарниры - 
I Walk Alone (Nightcore) - Crystal Lake vs Commercial Club Crew - 
Sayonara детка - Элджей feat. Era Istrefi - Sayonara детка - 
Shinkai Shoujo (深海少女) (Chorus) (multiple people) - Nico Nico Chorus (合唱) - 
No Regret - 倖田來未 - Complete Best - 
Даже Не Половина - Zomb (Зомб) - 
好想爱这个世界啊 - 华晨宇 - 新世界NEW WORLD - 
No title - Giga-P(ギガP) feat. Reol (れをる) - No title- - 
Future Cider - YUC'e (ゆーしえ) - EDP presents ravemania speed - 
Maple Fantasy - Assertive - VIVID HARDCORE -New Season- 4 - 
Senbon Zakura 千本桜 - kran - 
enhancer (2017 rework) - kamome sano - enhancer EP - 
x.U. (ETIA. Hardcore Bootleg Remix) - Hiroyuki Sawano - 
Future Cαndy - YUC'e (ゆーしえ) - Future Cαndy - 
Hurricane - Seventhrun - J-NERATION 8 - 
ヒステリックナイトガール - PSYQUI feat. Such - STYLEY! - 
Pomp and Circumstance (Ifuudoudou) (威風堂々) (Nhato Remix) - 梅とら - EXIT TUNES PRESENTS Entrance Dream Music3 - 
Pomp and Circumstance / Ifuudoudou (威風堂々) (柿チョコ Cover) - Megurine Luka, Hatsune Miku, IA, GUMI and Kagamine Rin - 
Reversible Campaign (「リバーシブル・キャンペーン) (Rurutia Dariya / roux Cover) - DECO*27 - 
Pure Furies ~ Vengeance is Mine (ピュアヒューリーズ ~ Vengeance is Mine) - Demetori (東方アレンジ) - Determinism&DestruKction - 
Dancing Wildly (狂喜乱舞) (柿チョコ Cover) - Megurine Luka, Hatsune Miku, and GUMI - 
JINGO JUNGLE (ESTA Remix)  - MYTH & ROID - 
INSOMNIA - whoo feat. lasah - INNOCENCE - 
MOMO SYRUP - Nor + YUC'e - MOMO SYRUP - 
Out In Middle - lapix - PsyStyle Nation - 
Orange Mocha Frappuccino - t+pazolite - 108 Sketches 5 - 
Eclipse - Powerless - pulvis et cinis - 
Fly Away Now - Ryunosuke Kudo and aran - CIERA - 
4 U Rave And Roll  - DJ Shimamura - EDP presents ravemania speed - 
Make Believe - Ryunosuke Kudo (工藤龍之介) - Honey Cheeks 2 -Purple Dress- - 
RIP in the Gossip Sea - cosMo feat. GUMI - 
FIRESTARTER - D.watt - バズリズシ ～I-O-P SELECTED vol.04～ - 
Renegade (Dub Elements Remix) - Eyes of Providence - 
Virtual Paradise - Aljosha Konstanty, Veela & Lynx - [non-album tracks] - 
If You Hadn't - KOAN Sound X Culprate X Asa X Opiuo - 
Go Go Ghost Ship (ゴーゴー幽霊船) - Kenshi Yonezu (米津玄師) - diorama - 
Akasagarbha (Hardcore Mix) - ETIA. vs wa. - 
Donut Hole (ドーナツホール) - GUMI - 
Living with Depression - Yanaga Miyuki feat. Hatsune Miku (初音ミク) - 
Patchwork Staccato (ツギハギスタッカート) - TOA (とあ) feat. Hatsune Miku (初音ミク) - EXIT TUNES PRESENTS Vocalofantasy - 
Shooting Star - TeddyLoid feat. IA - IA/03 -VISION- - 
Patchwork Staccato (ツギハギスタッカート) (Hyu Cover) - TOA (とあ) feat. Hatsune Miku (初音ミク) - 
メテオシャワ - DJ Shimamura feat. アイロボ - 
Ghost in the Hell - Hanyuu Maigo feat. Hatsune Miku (初音ミク) - 
えれくとりっく・えんじぇぅ - ななひら/れをる - ぎがばなな ざ べすと 〜NORISHIO味〜 - 
Suki Kirai (スキキライ) (GigaP (ギガP) Remix) - HoneyWorks feat. Kagamine Rin (鏡音リン), Kagamine Len (鏡音レン) - 六弦アストロジー - 
Party A - DJ Genki - A/LOG:02 - 
Suki Kirai (スキキライ) (GigaP (ギガP) Remix) - HoneyWorks feat. Megurine Luka (巡音ルカ), Hatsune Miku (初音ミク) - 六弦アストロジー - 
Alien Alien (エイリアンエイリアン) - NayutalieN (ナユタン星人) - 
3331 歌ってみた。 - nameless - 
nocturne - DJ Noriken - Omnifarious - 
Nobody Makes Sense - Pinocchio-P feat. Hatsune Miku (初音ミク) - 
Hate-Girl - Kairiki Bear feat. Hatsune Miku (初音ミク) - 
Never Rains (Nightcore) - Dance R Us - 
Sakura Mirage (Extended Mix) - Ryu☆ - Seventh Heaven - 
Egoist - Shero feat. Hatsune Miku (初音ミク) - 
とびだせ!バンキッキ(Casual Killer remix) - Shibayan Records - Sedecim - 
Dear you -Kind- - 雪宮雛希 - Dear you 「ひぐらしのなく頃に」イメージボーカルアルバム - 
MAD HEAD LOVE - Kenshi Yonezu (米津玄師) - YANKEE - 
Shut Uppp Love - YM feat. GUMI - 
Dancing Wildly (狂喜乱舞) (Cover) - Megurine Luka, Hatsune Miku, and GUMI - 
Get Down - Getty - Kirara Anthems vol.2 - 
you - Visionen im Spiegel - 癒月 - ひぐらしのなく頃に イメージアルバム かけらむすび - 
Tougen Renka (桃源恋歌) - GARNiDELiA - 
Deep Sea Girl (深海少女) (Nobunaga Cover) - Hatsune Miku (初音ミク) - 
Kyoukiranbu (響喜乱舞) - GARNiDELiA - 響喜乱舞 - 
Gokuraku Jodo (極楽浄土) - GARNiDELiA - 約束 -Promise code- - 
ニュース39 - Mitchie M feat. 初音ミク - 39D - 
tractrix - Soh Yoshioka feat. Hatsune Miku (初音ミク Append) - EXIT TUNES PRESENTS Entrance Dream Music - 
Alcoholman (알콜맨) - Stella Jang - 유해물질 - 
chameleon - nana (Sevencolors) feat. Hatsune Miku (初音ミク Sweet) - Sevencolors Works 2010 - 2011 - 
39 Music! (39みゅーじっく!) - Mikito-P (みきとP) feat. Hatsune Miku (初音ミク) - 初音ミク 「マジカルミライ 2016」 OFFICIAL ALBUM - 
Next Nest (ネクストネスト) - Hatsune Miku (初音ミク) feat. Satsuki ga Tenkomori (さつき が てんこもり) - マジカルミライ 2014 OFFICIAL ALBUM - 
You (Vocal) - 癒月 - Thanks/you - 
Shinkai Shoujo (深海少女) (Chorus) (6 people) - Nico Nico Chorus (合唱) - 
無炎舞踊≠循環 - EastNewSound - Split Theory - 
Dreamin' - Irus - M4D ESSENCE - 
S.A.T.O.R.A.R.E - Halozy - Future Love - 
アモリタチテカミトミユ - Syrufit - Where is Love - 
Spring Lane ~ Rest In Peace, Saith The Lord. (春色小径 ~ Rest In Peace, Saith The Lord.) - Demetori (東方アレンジ) - Determinism&DestruKction - 
宝相華 - C-CLAYS - 
とびだせ!バンキッキ - Shibayan Records - RETRO FUTURE GIRLS - 
緋色月下、狂咲ノ絶　(1st Anniversary Remix) - EastNewSound - Sacred Factor - 
Haitoku no Tsubomi (背徳の蕾 ) - IOSYS - キュートでアグレッシヴ☆幻想郷レボリューション - 
End of Daylight - Alstroemeria Records - genealogy | shrinemaiden - 
ダブルラリアット - アゴアニキ feat. 巡音ルカ - EXIT TUNES PRESENTS Megurhythm - 
Sadistic Paranoia - EastNewSound - Split Theory - 
If you're my destiny, end this fated determination - TUMENECO - 
Monochrome in the Night (モノクロ・インザナイト) - Shibayan Records - Adrastea - 
Monochrome in the Night (モノクロ・インザナイト) (CYTOKINE remix) - Shibayan Records - Sedecim - 
Ten Desires. - Syrufit / Poplica* - love - 
Black Butterfly - EastNewSound - Lucent Wish - 
Steady night - EastNewSound - Dione Aggregation - 
From the Deep Sea With Love (深海より愛を込めて) - Senya - 
Myosotis alpestris - Syrufit - Love Hearts? - 
シークレットシスターコンプレックス - Halozy - Halozy Best Vol.1 - 
Black Lotus - EastNewSound - Lucent Wish - 
萃夢想歌 - Silver Forest - Silver Forest 2006-2012 BEST1 - 
Gohatto Disco (さつき_が_てんこもり) - Hatsune Miku / Snow Miku (雪ミク) - 
恋のセレナーデ - Halozy - Tonic Triangle - 
君が望んだ永遠 - Silver Forest - Silver Forest 2006-2012 BEST1 - 
命の降る郷 - Liz Triangle - 
宝箱-TREASURE BOX- - 奥井雅美 - 宝箱-TREASURE BOX- / プラチナジェット - 
Sweet Devil (歌ってみた) (Reol (れをる) feat. Kradness) - Hachioji-P (八王子P)/8#Prince feat. Hatsune Miku (初音ミク) -  - 
COLORFUL BOX - 石田燿子 - COLORFUL BOX / Animetic Love Letter - 
Streaming Heart (ストリーミングハート) - Reol (れをる) - Upload feat.Vocalist - 
Systematic Love (システマティック・ラヴ) - Reol (れをる) - 
wanna go to a beach! VS. Resort Sunset - Camellia (かめりあ) - Camellia "Guest Tracks" Summary & VIPs 01 - 
MEGANTO METEOR - Camellia (かめりあ) - MEGANTO METEOR - 
ｼｬﾊﾞﾄﾞｩﾋﾞﾀｯﾁﾍﾝｼｰﾝ - ｹﾞﾘﾗ的 - 
KISEKAE (android52 edit) - android52 - android52 presents WELCOME NEW GALAXY - 
.Lilium.(Full.Version) - Elfen.Lied. - 
Yukitoki Chameleon (Oblongar Mashup) - Nagi Yanagi and Hatsune Miku - 
Future Cαndy (Braven Remix) - YUC'e (ゆーしえ) - 
Future Cαndy (i5cream Remix) - YUC'e (ゆーしえ) - 
Future Cαndy (RomTimney Remix) - YUC'e (ゆーしえ) - 
Mischievous Function (おちゃめ機能) - Lon (ろん) - 
N (エヌ) - Kurage-P (くらげP) feat. Kagamine Rin (鏡音リン) - 
Love Me If You Can (ヲタみん Cover) - Megurine Luka (巡音ルカ), IA (イア), Kagamine Rin (鏡音リン), GUMI (グミ), and Hatsune Miku (初音ミク) - 
Date Time （デートTIME) - Mineral Miracle Muse (ミネラル★ミラクル★ミューズ) - デートTIME - 
いけないBorder & Funky - fazerock - 
Ubawaretamono (ウバワレタモノ) - sasakure.UK feat. lasah - 不謌思戯モノユカシー - 
フェスで踊っているときに流れている曲 - スネ夫が - 
Soba ga Tabetai (そばが食べたい) - Mikeneko Homeless (三毛猫ホームレス) - インターネット e.p. - 
ラヴコリーダ - シシド・カフカ - カフカナイズ - 
HIBANA (ヒバナ) (柘榴 Cover) - DECO*27 feat. Hatsune Miku (初音ミク) - 
Lost in the Waves - Yoshimasa Hosoya - 
Beast Dance (ビースト・ダンス) - Kurage-P (くらげP) feat. 音街ウナ - 
Donut Hole (ドーナツホール) (鎖那 Cover) - GUMI - 
Blue Bird (ブルーバード)  - Lon (ろん) - 
フェスタ・イルミ*ーション × G*40 (mashup) - KyotoSketch  - 
Pomeguraneito (ポメグラネイト ここなつ) - Hinabita / Coconut (ひなビタ /ここなつ) - シンクロノーツ - 
5 Hyoshi / go byôshi (5拍子) - Midori (ミドリ) - Aratamemashite, Hajimemashite, Midori Desu - 
Love Doll (ラブドール) (そらる Cover) - DECO*27 - 
Fun Tonight - マクロスMACROSS 82-99 - CHAM! - 
Love Me If You Can - Megurine Luka (巡音ルカ), IA (イア), Kagamine Rin (鏡音リン), GUMI (グミ), and Hatsune Miku (初音ミク) - 
ワールズエンド・ダンスホール (ROCKETMAN remix) - wowaka feat. 初音ミク・巡音ルカ - 初音ミク DANCE REMIX vol.1 - 
Soba ga Tabetai (そばが食べたい) - Mikeneko Homeless (三毛猫ホームレス) feat. Nagi Nemoto (根本凪) - 
ペパーミント脱走計画 - Mikeneko Homeless (三毛猫ホームレス) x happy machine feat. Nagi Nemoto (根本凪) - 
Furu Biyori (ふゆびより) - Eri Sasaki (佐々木恵梨) - ふゆびより - 
Kimagure Mercy (気まぐれメルシィ) - Hachioji-P (八王子P) feat. Hatsune Miku (初音ミク) - Eight -THE BEST OF 八王子P- - 
I Miss You - マクロスMACROSS 82-99 with ローマンRoman - CHAM! - 
Carry Me Off - Hachioji-P (八王子P) feat. Hatsune Miku (初音ミク) - Twinkle World - 
Sweet Devil (八王子P VDM Remix) - Hachioji-P (八王子P)/8#Prince feat. Hatsune Miku (初音ミク) - Desktop Cinderella - 
Click (Asteriks Remix) - ClariS - 
Twinkle World - Hachioji-P (八王子P) feat. Hatsune Miku (初音ミク) - Twinkle World - 
Repairers of the Deceptive World (Kagaribito) (カガリビト) - Hatsune Miku (初音ミク) - 
Party Junkie (Colate Remix) - Hatsune Miku (初音ミク) - 
SeventH-HeaveN - sasakure.UK feat. Hatsune Miku (初音ミク) - 幻実アイソーポス - 
Zenzenzense (Movie Version) (Many Previous Existences) (前前前世) - RADWIMPS - Your Name - 
Setsuna ni Chiroutomo (刹那に散ろうとも) - Silver Forest - Rebirth - 
千本桜 - 和楽器バンド - ボカロ三昧 - 
ぶれないアイで - Mitchie M feat. 初音ミク - 39D - 
Solar System Disco (太陽系デスコ 歌った) (ARAKI (あらき)×nqrse Cover) - NayutalieN - 
談感情 (官方版MV) - Jeno Liu (劉力揚) - 
Mirror - Yasuda Rei (安田レイ) - Mirror - 
The Picture In My Heart (心中的圖畫) - Men Envy Children (小男孩樂團) - 
MR.TAXI (Dance ver.) (Music Video) [Japanese ver.] - Girls' Generation (소녀시대) (少女時代) - THE BEST - 
Surrounded by Enemies (Shimensoka) (四面楚歌) - Megurine Luka (巡音ルカ), IA (イア), Kagamine Rin (鏡音リン), GUMI (グミ), and Hatsune Miku (初音ミク) - 
The B♥chy Idol - Luo Tianyi (洛天依) - 
Tenstions (曖) (feat. ØZI) - Shi Shi (孫盛希) feat. ØZI - Shi's Journey (希遊記) - 
The Moon Represents My Heart (月亮代表我的心) - Teresa Teng (鄧麗君) - 難忘的Teresa Teng - 
MyonMyonMyonMyonMyonMyonMyon! - Shibayan Records - RETRO FUTURE GIRLS - 
If I Were Young (年少有為) - Ronghao Li (李榮浩) - 耳朵 - 
MyonMyonMyonMyonMyonMyon! - 3L - ムソウマテリアライズ - 
invitation - Kou Shibasaki (柴咲コウ) - 嬉々♥ - 
Desert Years - Shibayan Records - RETRO FUTURE GIRLS - 
Mukei Spirit (無形スピリット) Mugen Loop Remix (TeddyLoid Remix) - Kou Shibasaki (柴咲コウ) - 無形スピリット - 
Dancing Whitebait - 源屋 - Bright Colors 3 - 
NEXT STAY (DJ Noriken Remix) - Minamotoya (源屋) - 
Last Night - 源屋 feat. motoko - Bright Colors - 
Moonlight (feat. 袁婭維) - Will Pan (潘瑋柏) feat. Tia Ray (袁娅维) - Moonlight - 
Moonlight (feat. 袁婭維) [中文版] - Will Pan (潘瑋柏) feat. Tia Ray (袁娅维) - Moonlight - 
劈你的雷正在路上 - Cyndi Wang (王心凌) - CYNDILOVES2SING 爱。心凌 - 
犬Kあ3L - 澤野弘之 - KILL la KILL ORIGINAL SOUND TRACK - 
デモムービー - 花の野に咲くうたかたの  - 
Those Bygone Years (那些年) - Hu Xia (胡夏) - 燃點 - 
Honey Moon Un Deux Trois (蜜月アン・ドゥ・トロワ) (Kurokumo (くろくも or 黒雲) Cover) - DATEKEN feat. Kagamine Rin (鏡音リン) - 
Life Sucks (消極掰) - Jolin Tsai (蔡依林) - Ugly Beauty - 
Sakasama Bridge (逆様ブリッジ) - Suneohair (スネオヘアー) - 逆様ブリッジ - 
Honey Moon Un Deux Trois (蜜月アン・ドゥ・トロワ) (Rina (里奈) Cover) - DATEKEN feat. Kagamine Rin (鏡音リン) - 
鬼龍G@キLL - 澤野弘之 - BEST OF SOUNDTRACK【emU】 - 
HUSTLE - Tifa Chen (陈梓童) - HUSTLE - 
JINGO JUNGLE - MYTH & ROID - JINGO JUNGLE - 
Sparkle (Movie Version) (Supākuru) (スパークル) - RADWIMPS - Your Name - 
Karma - Dareharu - Karma - 
Sting (찔려) - Stellar (스텔라) - 찔려 - 
Comes And Goes (와리가리) - Hyukoh (혁오) - 22 - 
ct16041 + ct16031 - KIRARA (키라라) - 
Gee - Girls` Generation(소녀시대) - Gee - 
恢复 - 2814 - 新しい日の誕生 - 
The Refrain of the Lovely Great War - Jun.A - 
Neurotic - Boygem - 
I'll Still Have Me - CYN - Mood Swing - 
